0,1,2,3,4,5,6,7,8,9,10,11,12,13,14,15,16,17,18,19
"[-10, -10, -10, -10, -10, -10, -10, -10, -10, -10]","[3, 3, 3, 3, 3, 3, 3, 3, 3, 3]",-100,-100,"[-1, -1, -1, -1, -1, -10, -10, -10, -10, -10]","[0, 2, 2, 1, 5, 1, 1, 1, 1, 1]",-55,-55,"[-1, -1, -1, -1, -10, -10, -10, -10, -10, -10]","[0, 3, 1, 5, 1, 1, 1, 1, 1, 1]",-64,-64,"[-1, -1, -1, -10, -10, -10, -10, -10, -10, -10]","[0, 2, 2, 1, 1, 1, 1, 1, 1, 1]",-73,-73,"[-1, -1, -10, -10, -10, -10, -10, -10, -10, -10]","[0, 2, 1, 1, 1, 1, 1, 1, 1, 1]",-82,-82
"[-10, -10, -10, -10, -10, -10, -10, -10, -10, -10]","[3, 3, 3, 3, 3, 3, 3, 3, 3, 3]",-100,-200,"[-10, -10, -10, -10, -10, -10, -10, -10, -10, -10]","[2, 2, 2, 2, 2, 2, 2, 2, 2, 2]",-100,-155,"[-10, -10, -10, -10, -10, -10, -10, -10, -10, -10]","[2, 2, 2, 2, 2, 2, 2, 2, 2, 2]",-100,-164,"[-10, -10, -10, -10, -10, -10, -10, -10, -10, -10]","[2, 2, 2, 2, 2, 2, 2, 2, 2, 2]",-100,-173,"[-1, -1, -10, -10, -10, -10, -10, -10, -10, -10]","[0, 2, 1, 1, 1, 1, 1, 1, 1, 1]",-82,-164
"[-10, -10, -10, -10, -10, -10, -10, -10, -10, -10]","[3, 3, 3, 3, 3, 3, 3, 3, 3, 3]",-100,-300,"[-10, -10, -10, -10, -10, -10, -10, -10, -10, -10]","[3, 3, 3, 3, 3, 3, 3, 3, 3, 3]",-100,-255,"[-1, -1, -1, -10, -10, -10, -10, -10, -10, -10]","[0, 2, 2, 1, 1, 1, 1, 1, 1, 1]",-73,-237,"[-1, -1, -1, -1, -10, -10, -10, -10, -10, -10]","[0, 3, 1, 5, 1, 1, 1, 1, 1, 1]",-64,-237,"[-10, -10, -10, -10, -10, -10, -10, -10, -10, -10]","[3, 3, 3, 3, 3, 3, 3, 3, 3, 3]",-100,-264
"[-10, -10, -10, -10, -10, -10, -10, -10, -10, -10]","[3, 3, 3, 3, 3, 3, 3, 3, 3, 3]",-100,-400,"[-10, -10, -10, -10, -10, -10, -10, -10, -10, -10]","[3, 3, 3, 3, 3, 3, 3, 3, 3, 3]",-100,-355,"[-10, -10, -10, -10, -10, -10, -10, -10, -10, -10]","[2, 2, 2, 2, 2, 2, 2, 2, 2, 2]",-100,-337,"[-10, -10, -10, -10, -10, -10, -10, -10, -10, -10]","[2, 2, 2, 2, 2, 2, 2, 2, 2, 2]",-100,-337,"[-10, -10, -10, -10, -10, -10, -10, -10, -10, -10]","[3, 3, 3, 3, 3, 3, 3, 3, 3, 3]",-100,-364
"[-1, -1, -1, -10, -10, -10, -10, -10, -10, -10]","[0, 2, 2, 1, 1, 1, 1, 1, 1, 1]",-73,-473,"[-10, -10, -10, -10, -10, -10, -10, -10, -10, -10]","[3, 3, 3, 3, 3, 3, 3, 3, 3, 3]",-100,-455,"[-1, -1, -1, -10, -10, -10, -10, -10, -10, -10]","[0, 1, 5, 1, 1, 1, 1, 1, 1, 1]",-73,-410,"[-1, -1, -1, -10, -10, -10, -10, -10, -10, -10]","[0, 2, 2, 1, 1, 1, 1, 1, 1, 1]",-73,-410,"[-10, -10, -10, -10, -10, -10, -10, -10, -10, -10]","[3, 3, 3, 3, 3, 3, 3, 3, 3, 3]",-100,-464
"[-1, -1, -10, -10, -10, -10, -10, -10, -10, -10]","[0, 2, 1, 1, 1, 1, 1, 1, 1, 1]",-82,-555,"[-10, -10, -10, -10, -10, -10, -10, -10, -10, -10]","[3, 3, 3, 3, 3, 3, 3, 3, 3, 3]",-100,-555,"[-10, -10, -10, -10, -10, -10, -10, -10, -10, -10]","[2, 2, 2, 2, 2, 2, 2, 2, 2, 2]",-100,-510,"[-10, -10, -10, -10, -10, -10, -10, -10, -10, -10]","[2, 2, 2, 2, 2, 2, 2, 2, 2, 2]",-100,-510,"[-10, -10, -10, -10, -10, -10, -10, -10, -10, -10]","[3, 3, 3, 3, 3, 3, 3, 3, 3, 3]",-100,-564
"[-10, -10, -10, -10, -10, -10, -10, -10, -10, -10]","[2, 2, 2, 2, 2, 2, 2, 2, 2, 2]",-100,-655,"[-10, -10, -10, -10, -10, -10, -10, -10, -10, -10]","[3, 3, 3, 3, 3, 3, 3, 3, 3, 3]",-100,-655,"[-10, -10, -10, -10, -10, -10, -10, -10, -10, -10]","[3, 3, 3, 3, 3, 3, 3, 3, 3, 3]",-100,-610,"[-10, -10, -10, -10, -10, -10, -10, -10, -10, -10]","[2, 2, 2, 2, 2, 2, 2, 2, 2, 2]",-100,-610,"[-1, -1, -10, -10, -10, -10, -10, -10, -10, -10]","[0, 2, 1, 1, 1, 1, 1, 1, 1, 1]",-82,-646
"[-10, -10, -10, -10, -10, -10, -10, -10, -10, -10]","[2, 2, 2, 2, 2, 2, 2, 2, 2, 2]",-100,-755,"[-1, -10, -10, -10, -10, -10, -10, -10, -10, -10]","[0, 1, 1, 1, 1, 1, 1, 1, 1, 1]",-91,-746,"[-1, -1, -1, -10, -10, -10, -10, -10, -10, -10]","[0, 2, 2, 1, 1, 1, 1, 1, 1, 1]",-73,-683,"[-10, -10, -10, -10, -10, -10, -10, -10, -10, -10]","[2, 2, 2, 2, 2, 2, 2, 2, 2, 2]",-100,-710,"[-1, -1, -1, -10, -10, -10, -10, -10, -10, -10]","[0, 2, 2, 1, 1, 1, 1, 1, 1, 1]",-73,-719
"[-10, -10, -10, -10, -10, -10, -10, -10, -10, -10]","[2, 2, 2, 2, 2, 2, 2, 2, 2, 2]",-100,-855,"[-1, -1, -1, -1, -10, -10, -10, -10, -10, -10]","[0, 2, 1, 5, 1, 1, 1, 1, 1, 1]",-64,-810,"[-1, -1, -10, -10, -10, -10, -10, -10, -10, -10]","[0, 2, 1, 1, 1, 1, 1, 1, 1, 1]",-82,-765,"[-10, -10, -10, -10, -10, -10, -10, -10, -10, -10]","[2, 2, 2, 2, 2, 2, 2, 2, 2, 2]",-100,-810,"[-10, -10, -10, -10, -10, -10, -10, -10, -10, -10]","[3, 3, 3, 3, 3, 3, 3, 3, 3, 3]",-100,-819
"[-10, -10, -10, -10, -10, -10, -10, -10, -10, -10]","[2, 2, 2, 2, 2, 2, 2, 2, 2, 2]",-100,-955,"[-10, -10, -10, -10, -10, -10, -10, -10, -10, -10]","[2, 2, 2, 2, 2, 2, 2, 2, 2, 2]",-100,-910,"[-10, -10, -10, -10, -10, -10, -10, -10, -10, -10]","[3, 3, 3, 3, 3, 3, 3, 3, 3, 3]",-100,-865,"[-10, -10, -10, -10, -10, -10, -10, -10, -10, -10]","[2, 2, 2, 2, 2, 2, 2, 2, 2, 2]",-100,-910,"[-10, -10, -10, -10, -10, -10, -10, -10, -10, -10]","[2, 2, 2, 2, 2, 2, 2, 2, 2, 2]",-100,-919
"[-1, -1, -10, -10, -10, -10, -10, -10, -10, -10]","[0, 2, 1, 1, 1, 1, 1, 1, 1, 1]",-82,-1037,"[-10, -10, -10, -10, -10, -10, -10, -10, -10, -10]","[3, 3, 3, 3, 3, 3, 3, 3, 3, 3]",-100,-1010,"[-10, -10, -10, -10, -10, -10, -10, -10, -10, -10]","[2, 2, 2, 2, 2, 2, 2, 2, 2, 2]",-100,-965,"[-10, -10, -10, -10, -10, -10, -10, -10, -10, -10]","[2, 2, 2, 2, 2, 2, 2, 2, 2, 2]",-100,-1010,"[-10, -10, -10, -10, -10, -10, -10, -10, -10, -10]","[2, 2, 2, 2, 2, 2, 2, 2, 2, 2]",-100,-1019
"[-1, -10, -10, -10, -10, -10, -10, -10, -10, -10]","[0, 1, 1, 1, 1, 1, 1, 1, 1, 1]",-91,-1128,"[-1, -1, -1, -10, -10, -10, -10, -10, -10, -10]","[0, 2, 2, 1, 1, 1, 1, 1, 1, 1]",-73,-1083,"[-1, -1, -10, -10, -10, -10, -10, -10, -10, -10]","[0, 2, 1, 1, 1, 1, 1, 1, 1, 1]",-82,-1047,"[-1, -1, -1, -1, -10, -10, -10, -10, -10, -10]","[0, 2, 1, 5, 1, 1, 1, 1, 1, 1]",-64,-1074,"[-1, -1, -1, -1, -10, -10, -10, -10, -10, -10]","[0, 2, 1, 5, 1, 1, 1, 1, 1, 1]",-64,-1083
"[-1, -1, -1, -10, -10, -10, -10, -10, -10, -10]","[0, 2, 2, 1, 1, 1, 1, 1, 1, 1]",-73,-1201,"[-1, -1, -10, -10, -10, -10, -10, -10, -10, -10]","[0, 2, 1, 1, 1, 1, 1, 1, 1, 1]",-82,-1165,"[-10, -10, -10, -10, -10, -10, -10, -10, -10, -10]","[2, 2, 2, 2, 2, 2, 2, 2, 2, 2]",-100,-1147,"[-1, -1, -10, -10, -10, -10, -10, -10, -10, -10]","[0, 2, 1, 1, 1, 1, 1, 1, 1, 1]",-82,-1156,"[-1, -1, -1, -10, -10, -10, -10, -10, -10, -10]","[0, 2, 2, 1, 1, 1, 1, 1, 1, 1]",-73,-1156
"[-10, -10, -10, -10, -10, -10, -10, -10, -10, -10]","[3, 3, 3, 3, 3, 3, 3, 3, 3, 3]",-100,-1301,"[-10, -10, -10, -10, -10, -10, -10, -10, -10, -10]","[2, 2, 2, 2, 2, 2, 2, 2, 2, 2]",-100,-1265,"[-1, -1, -1, -10, -10, -10, -10, -10, -10, -10]","[0, 2, 2, 1, 1, 1, 1, 1, 1, 1]",-73,-1220,"[-10, -10, -10, -10, -10, -10, -10, -10, -10, -10]","[2, 2, 2, 2, 2, 2, 2, 2, 2, 2]",-100,-1256,"[-1, -1, -1, -10, -10, -10, -10, -10, -10, -10]","[0, 2, 2, 1, 1, 1, 1, 1, 1, 1]",-73,-1229
"[-1, -1, -10, -10, -10, -10, -10, -10, -10, -10]","[0, 2, 1, 1, 1, 1, 1, 1, 1, 1]",-82,-1383,"[-10, -10, -10, -10, -10, -10, -10, -10, -10, -10]","[2, 2, 2, 2, 2, 2, 2, 2, 2, 2]",-100,-1365,"[-10, -10, -10, -10, -10, -10, -10, -10, -10, -10]","[3, 3, 3, 3, 3, 3, 3, 3, 3, 3]",-100,-1320,"[-1, -1, -1, -10, -10, -10, -10, -10, -10, -10]","[0, 2, 2, 1, 1, 1, 1, 1, 1, 1]",-73,-1329,"[-1, -1, -1, -10, -10, -10, -10, -10, -10, -10]","[0, 2, 2, 1, 1, 1, 1, 1, 1, 1]",-73,-1302
"[-10, -10, -10, -10, -10, -10, -10, -10, -10, -10]","[3, 3, 3, 3, 3, 3, 3, 3, 3, 3]",-100,-1483,"[-10, -10, -10, -10, -10, -10, -10, -10, -10, -10]","[2, 2, 2, 2, 2, 2, 2, 2, 2, 2]",-100,-1465,"[-1, -1, -1, -10, -10, -10, -10, -10, -10, -10]","[0, 2, 2, 1, 1, 1, 1, 1, 1, 1]",-73,-1393,"[-10, -10, -10, -10, -10, -10, -10, -10, -10, -10]","[3, 3, 3, 3, 3, 3, 3, 3, 3, 3]",-100,-1429,"[-1, -1, -1, -10, -10, -10, -10, -10, -10, -10]","[0, 2, 2, 1, 1, 1, 1, 1, 1, 1]",-73,-1375
"[-10, -10, -10, -10, -10, -10, -10, -10, -10, -10]","[2, 2, 2, 2, 2, 2, 2, 2, 2, 2]",-100,-1583,"[-10, -10, -10, -10, -10, -10, -10, -10, -10, -10]","[3, 3, 3, 3, 3, 3, 3, 3, 3, 3]",-100,-1565,"[-10, -10, -10, -10, -10, -10, -10, -10, -10, -10]","[2, 2, 2, 2, 2, 2, 2, 2, 2, 2]",-100,-1493,"[-10, -10, -10, -10, -10, -10, -10, -10, -10, -10]","[2, 2, 2, 2, 2, 2, 2, 2, 2, 2]",-100,-1529,"[-10, -10, -10, -10, -10, -10, -10, -10, -10, -10]","[2, 2, 2, 2, 2, 2, 2, 2, 2, 2]",-100,-1475
"[-10, -10, -10, -10, -10, -10, -10, -10, -10, -10]","[2, 2, 2, 2, 2, 2, 2, 2, 2, 2]",-100,-1683,"[-10, -10, -10, -10, -10, -10, -10, -10, -10, -10]","[2, 2, 2, 2, 2, 2, 2, 2, 2, 2]",-100,-1665,"[-10, -10, -10, -10, -10, -10, -10, -10, -10, -10]","[2, 2, 2, 2, 2, 2, 2, 2, 2, 2]",-100,-1593,"[-10, -10, -10, -10, -10, -10, -10, -10, -10, -10]","[2, 2, 2, 2, 2, 2, 2, 2, 2, 2]",-100,-1629,"[-10, -10, -10, -10, -10, -10, -10, -10, -10, -10]","[2, 2, 2, 2, 2, 2, 2, 2, 2, 2]",-100,-1575
"[-1, -1, -1, -10, -10, -10, -10, -10, -10, -10]","[0, 2, 2, 1, 1, 1, 1, 1, 1, 1]",-73,-1756,"[-10, -10, -10, -10, -10, -10, -10, -10, -10, -10]","[3, 3, 3, 3, 3, 3, 3, 3, 3, 3]",-100,-1765,"[-1, -1, -10, -10, -10, -10, -10, -10, -10, -10]","[0, 2, 1, 1, 1, 1, 1, 1, 1, 1]",-82,-1675,"[-10, -10, -10, -10, -10, -10, -10, -10, -10, -10]","[2, 2, 2, 2, 2, 2, 2, 2, 2, 2]",-100,-1729,"[-10, -10, -10, -10, -10, -10, -10, -10, -10, -10]","[2, 2, 2, 2, 2, 2, 2, 2, 2, 2]",-100,-1675
"[-1, -1, -1, -10, -10, -10, -10, -10, -10, -10]","[0, 2, 2, 1, 1, 1, 1, 1, 1, 1]",-73,-1829,"[-1, -1, -1, -10, -10, -10, -10, -10, -10, -10]","[0, 2, 2, 1, 1, 1, 1, 1, 1, 1]",-73,-1838,"[-10, -10, -10, -10, -10, -10, -10, -10, -10, -10]","[2, 2, 2, 2, 2, 2, 2, 2, 2, 2]",-100,-1775,"[-10, -10, -10, -10, -10, -10, -10, -10, -10, -10]","[2, 2, 2, 2, 2, 2, 2, 2, 2, 2]",-100,-1829,"[-10, -10, -10, -10, -10, -10, -10, -10, -10, -10]","[2, 2, 2, 2, 2, 2, 2, 2, 2, 2]",-100,-1775
"[-1, -1, -1, -10, -10, -10, -10, -10, -10, -10]","[0, 2, 2, 1, 1, 1, 1, 1, 1, 1]",-73,-1902,"[-1, -1, -1, -1, -10, -10, -10, -10, -10, -10]","[0, 2, 1, 5, 1, 1, 1, 1, 1, 1]",-64,-1902,"[-1, -1, -10, -10, -10, -10, -10, -10, -10, -10]","[0, 2, 1, 1, 1, 1, 1, 1, 1, 1]",-82,-1857,"[-1, -1, -10, -10, -10, -10, -10, -10, -10, -10]","[0, 2, 1, 1, 1, 1, 1, 1, 1, 1]",-82,-1911,"[-10, -10, -10, -10, -10, -10, -10, -10, -10, -10]","[2, 2, 2, 2, 2, 2, 2, 2, 2, 2]",-100,-1875
"[-10, -10, -10, -10, -10, -10, -10, -10, -10, -10]","[2, 2, 2, 2, 2, 2, 2, 2, 2, 2]",-100,-2002,"[-1, -1, -10, -10, -10, -10, -10, -10, -10, -10]","[0, 2, 1, 1, 1, 1, 1, 1, 1, 1]",-82,-1984,"[-1, -1, -1, -10, -10, -10, -10, -10, -10, -10]","[0, 2, 2, 1, 1, 1, 1, 1, 1, 1]",-73,-1930,"[-10, -10, -10, -10, -10, -10, -10, -10, -10, -10]","[2, 2, 2, 2, 2, 2, 2, 2, 2, 2]",-100,-2011,"[-1, -1, -10, -10, -10, -10, -10, -10, -10, -10]","[0, 2, 1, 1, 1, 1, 1, 1, 1, 1]",-82,-1957
"[-10, -10, -10, -10, -10, -10, -10, -10, -10, -10]","[2, 2, 2, 2, 2, 2, 2, 2, 2, 2]",-100,-2102,"[-10, -10, -10, -10, -10, -10, -10, -10, -10, -10]","[2, 2, 2, 2, 2, 2, 2, 2, 2, 2]",-100,-2084,"[-1, -1, -1, -1, -10, -10, -10, -10, -10, -10]","[0, 2, 1, 5, 1, 1, 1, 1, 1, 1]",-64,-1994,"[-10, -10, -10, -10, -10, -10, -10, -10, -10, -10]","[3, 3, 3, 3, 3, 3, 3, 3, 3, 3]",-100,-2111,"[-1, -1, -10, -10, -10, -10, -10, -10, -10, -10]","[0, 2, 1, 1, 1, 1, 1, 1, 1, 1]",-82,-2039
"[-10, -10, -10, -10, -10, -10, -10, -10, -10, -10]","[2, 2, 2, 2, 2, 2, 2, 2, 2, 2]",-100,-2202,"[-10, -10, -10, -10, -10, -10, -10, -10, -10, -10]","[2, 2, 2, 2, 2, 2, 2, 2, 2, 2]",-100,-2184,"[-10, -10, -10, -10, -10, -10, -10, -10, -10, -10]","[3, 3, 3, 3, 3, 3, 3, 3, 3, 3]",-100,-2094,"[-10, -10, -10, -10, -10, -10, -10, -10, -10, -10]","[2, 2, 2, 2, 2, 2, 2, 2, 2, 2]",-100,-2211,"[-1, -1, -1, -1, -10, -10, -10, -10, -10, -10]","[0, 2, 1, 5, 1, 1, 1, 1, 1, 1]",-64,-2103
"[-1, -1, -1, -10, -10, -10, -10, -10, -10, -10]","[0, 2, 2, 1, 1, 1, 1, 1, 1, 1]",-73,-2275,"[-1, -1, -1, -10, -10, -10, -10, -10, -10, -10]","[0, 2, 2, 1, 1, 1, 1, 1, 1, 1]",-73,-2257,"[-10, -10, -10, -10, -10, -10, -10, -10, -10, -10]","[2, 2, 2, 2, 2, 2, 2, 2, 2, 2]",-100,-2194,"[-10, -10, -10, -10, -10, -10, -10, -10, -10, -10]","[2, 2, 2, 2, 2, 2, 2, 2, 2, 2]",-100,-2311,"[-1, -1, -1, -10, -10, -10, -10, -10, -10, -10]","[0, 2, 2, 1, 1, 1, 1, 1, 1, 1]",-73,-2176
"[-10, -10, -10, -10, -10, -10, -10, -10, -10, -10]","[2, 2, 2, 2, 2, 2, 2, 2, 2, 2]",-100,-2375,"[-1, -1, -1, -1, -1, -10, -10, -10, -10, -10]","[0, 2, 2, 1, 5, 1, 1, 1, 1, 1]",-55,-2312,"[-10, -10, -10, -10, -10, -10, -10, -10, -10, -10]","[2, 2, 2, 2, 2, 2, 2, 2, 2, 2]",-100,-2294,"[-10, -10, -10, -10, -10, -10, -10, -10, -10, -10]","[2, 2, 2, 2, 2, 2, 2, 2, 2, 2]",-100,-2411,"[-10, -10, -10, -10, -10, -10, -10, -10, -10, -10]","[2, 2, 2, 2, 2, 2, 2, 2, 2, 2]",-100,-2276
"[-10, -10, -10, -10, -10, -10, -10, -10, -10, -10]","[2, 2, 2, 2, 2, 2, 2, 2, 2, 2]",-100,-2475,"[-10, -10, -10, -10, -10, -10, -10, -10, -10, -10]","[3, 3, 3, 3, 3, 3, 3, 3, 3, 3]",-100,-2412,"[-10, -10, -10, -10, -10, -10, -10, -10, -10, -10]","[3, 3, 3, 3, 3, 3, 3, 3, 3, 3]",-100,-2394,"[-1, -1, -1, -10, -10, -10, -10, -10, -10, -10]","[0, 1, 5, 1, 1, 1, 1, 1, 1, 1]",-73,-2484,"[-10, -10, -10, -10, -10, -10, -10, -10, -10, -10]","[2, 2, 2, 2, 2, 2, 2, 2, 2, 2]",-100,-2376
"[-10, -10, -10, -10, -10, -10, -10, -10, -10, -10]","[2, 2, 2, 2, 2, 2, 2, 2, 2, 2]",-100,-2575,"[-1, -1, -1, -10, -10, -10, -10, -10, -10, -10]","[0, 2, 2, 1, 1, 1, 1, 1, 1, 1]",-73,-2485,"[-10, -10, -10, -10, -10, -10, -10, -10, -10, -10]","[2, 2, 2, 2, 2, 2, 2, 2, 2, 2]",-100,-2494,"[-1, -1, -10, -10, -10, -10, -10, -10, -10, -10]","[0, 2, 1, 1, 1, 1, 1, 1, 1, 1]",-82,-2566,"[-1, -1, -1, -1, -10, -10, -10, -10, -10, -10]","[0, 2, 1, 5, 1, 1, 1, 1, 1, 1]",-64,-2440
"[-10, -10, -10, -10, -10, -10, -10, -10, -10, -10]","[3, 3, 3, 3, 3, 3, 3, 3, 3, 3]",-100,-2675,"[-10, -10, -10, -10, -10, -10, -10, -10, -10, -10]","[2, 2, 2, 2, 2, 2, 2, 2, 2, 2]",-100,-2585,"[-10, -10, -10, -10, -10, -10, -10, -10, -10, -10]","[2, 2, 2, 2, 2, 2, 2, 2, 2, 2]",-100,-2594,"[-1, -1, -10, -10, -10, -10, -10, -10, -10, -10]","[0, 2, 1, 1, 1, 1, 1, 1, 1, 1]",-82,-2648,"[-1, -1, -1, -10, -10, -10, -10, -10, -10, -10]","[0, 2, 2, 1, 1, 1, 1, 1, 1, 1]",-73,-2513
"[-1, -1, -1, -1, -10, -10, -10, -10, -10, -10]","[0, 2, 1, 5, 1, 1, 1, 1, 1, 1]",-64,-2739,"[-10, -10, -10, -10, -10, -10, -10, -10, -10, -10]","[2, 2, 2, 2, 2, 2, 2, 2, 2, 2]",-100,-2685,"[-10, -10, -10, -10, -10, -10, -10, -10, -10, -10]","[2, 2, 2, 2, 2, 2, 2, 2, 2, 2]",-100,-2694,"[-10, -10, -10, -10, -10, -10, -10, -10, -10, -10]","[2, 2, 2, 2, 2, 2, 2, 2, 2, 2]",-100,-2748,"[-10, -10, -10, -10, -10, -10, -10, -10, -10, -10]","[3, 3, 3, 3, 3, 3, 3, 3, 3, 3]",-100,-2613
"[-1, -1, -1, -10, -10, -10, -10, -10, -10, -10]","[0, 2, 2, 1, 1, 1, 1, 1, 1, 1]",-73,-2812,"[-1, -1, -10, -10, -10, -10, -10, -10, -10, -10]","[0, 2, 1, 1, 1, 1, 1, 1, 1, 1]",-82,-2767,"[-10, -10, -10, -10, -10, -10, -10, -10, -10, -10]","[2, 2, 2, 2, 2, 2, 2, 2, 2, 2]",-100,-2794,"[-10, -10, -10, -10, -10, -10, -10, -10, -10, -10]","[2, 2, 2, 2, 2, 2, 2, 2, 2, 2]",-100,-2848,"[-1, -1, -10, -10, -10, -10, -10, -10, -10, -10]","[0, 2, 1, 1, 1, 1, 1, 1, 1, 1]",-82,-2695
"[-1, -1, -1, -1, -10, -10, -10, -10, -10, -10]","[0, 2, 1, 5, 1, 1, 1, 1, 1, 1]",-64,-2876,"[-10, -10, -10, -10, -10, -10, -10, -10, -10, -10]","[3, 3, 3, 3, 3, 3, 3, 3, 3, 3]",-100,-2867,"[-10, -10, -10, -10, -10, -10, -10, -10, -10, -10]","[3, 3, 3, 3, 3, 3, 3, 3, 3, 3]",-100,-2894,"[-10, -10, -10, -10, -10, -10, -10, -10, -10, -10]","[3, 3, 3, 3, 3, 3, 3, 3, 3, 3]",-100,-2948,"[-10, -10, -10, -10, -10, -10, -10, -10, -10, -10]","[2, 2, 2, 2, 2, 2, 2, 2, 2, 2]",-100,-2795
"[-1, -1, -1, -1, -10, -10, -10, -10, -10, -10]","[0, 2, 1, 5, 1, 1, 1, 1, 1, 1]",-64,-2940,"[-1, -10, -10, -10, -10, -10, -10, -10, -10, -10]","[0, 1, 1, 1, 1, 1, 1, 1, 1, 1]",-91,-2958,"[-1, -1, -1, -1, -10, -10, -10, -10, -10, -10]","[0, 2, 1, 5, 1, 1, 1, 1, 1, 1]",-64,-2958,"[-10, -10, -10, -10, -10, -10, -10, -10, -10, -10]","[2, 2, 2, 2, 2, 2, 2, 2, 2, 2]",-100,-3048,"[-10, -10, -10, -10, -10, -10, -10, -10, -10, -10]","[3, 3, 3, 3, 3, 3, 3, 3, 3, 3]",-100,-2895
"[-10, -10, -10, -10, -10, -10, -10, -10, -10, -10]","[2, 2, 2, 2, 2, 2, 2, 2, 2, 2]",-100,-3040,"[-1, -10, -10, -10, -10, -10, -10, -10, -10, -10]","[0, 1, 1, 1, 1, 1, 1, 1, 1, 1]",-91,-3049,"[-10, -10, -10, -10, -10, -10, -10, -10, -10, -10]","[3, 3, 3, 3, 3, 3, 3, 3, 3, 3]",-100,-3058,"[-10, -10, -10, -10, -10, -10, -10, -10, -10, -10]","[2, 2, 2, 2, 2, 2, 2, 2, 2, 2]",-100,-3148,"[-10, -10, -10, -10, -10, -10, -10, -10, -10, -10]","[3, 3, 3, 3, 3, 3, 3, 3, 3, 3]",-100,-2995
"[-10, -10, -10, -10, -10, -10, -10, -10, -10, -10]","[3, 3, 3, 3, 3, 3, 3, 3, 3, 3]",-100,-3140,"[-10, -10, -10, -10, -10, -10, -10, -10, -10, -10]","[2, 2, 2, 2, 2, 2, 2, 2, 2, 2]",-100,-3149,"[-10, -10, -10, -10, -10, -10, -10, -10, -10, -10]","[2, 2, 2, 2, 2, 2, 2, 2, 2, 2]",-100,-3158,"[-10, -10, -10, -10, -10, -10, -10, -10, -10, -10]","[2, 2, 2, 2, 2, 2, 2, 2, 2, 2]",-100,-3248,"[-10, -10, -10, -10, -10, -10, -10, -10, -10, -10]","[3, 3, 3, 3, 3, 3, 3, 3, 3, 3]",-100,-3095
"[-1, -1, -1, -1, -10, -10, -10, -10, -10, -10]","[0, 2, 1, 5, 1, 1, 1, 1, 1, 1]",-64,-3204,"[-10, -10, -10, -10, -10, -10, -10, -10, -10, -10]","[2, 2, 2, 2, 2, 2, 2, 2, 2, 2]",-100,-3249,"[-10, -10, -10, -10, -10, -10, -10, -10, -10, -10]","[3, 3, 3, 3, 3, 3, 3, 3, 3, 3]",-100,-3258,"[-10, -10, -10, -10, -10, -10, -10, -10, -10, -10]","[2, 2, 2, 2, 2, 2, 2, 2, 2, 2]",-100,-3348,"[-10, -10, -10, -10, -10, -10, -10, -10, -10, -10]","[2, 2, 2, 2, 2, 2, 2, 2, 2, 2]",-100,-3195
"[-10, -10, -10, -10, -10, -10, -10, -10, -10, -10]","[2, 2, 2, 2, 2, 2, 2, 2, 2, 2]",-100,-3304,"[-10, -10, -10, -10, -10, -10, -10, -10, -10, -10]","[2, 2, 2, 2, 2, 2, 2, 2, 2, 2]",-100,-3349,"[-1, -1, -1, -10, -10, -10, -10, -10, -10, -10]","[0, 2, 2, 1, 1, 1, 1, 1, 1, 1]",-73,-3331,"[-1, -10, -10, -10, -10, -10, -10, -10, -10, -10]","[0, 1, 1, 1, 1, 1, 1, 1, 1, 1]",-91,-3439,"[-1, -1, -1, -1, -1, -10, -10, -10, -10, -10]","[0, 2, 2, 1, 5, 1, 1, 1, 1, 1]",-55,-3250
"[-1, -1, -1, -10, -10, -10, -10, -10, -10, -10]","[0, 2, 2, 1, 1, 1, 1, 1, 1, 1]",-73,-3377,"[-10, -10, -10, -10, -10, -10, -10, -10, -10, -10]","[3, 3, 3, 3, 3, 3, 3, 3, 3, 3]",-100,-3449,"[-1, -1, -1, -10, -10, -10, -10, -10, -10, -10]","[0, 2, 2, 1, 1, 1, 1, 1, 1, 1]",-73,-3404,"[-1, -1, -1, -1, -1, -10, -10, -10, -10, -10]","[0, 2, 2, 1, 5, 1, 1, 1, 1, 1]",-55,-3494,"[-10, -10, -10, -10, -10, -10, -10, -10, -10, -10]","[3, 3, 3, 3, 3, 3, 3, 3, 3, 3]",-100,-3350
"[-1, -1, -1, -1, -1, -10, -10, -10, -10, -10]","[0, 2, 2, 1, 5, 1, 1, 1, 1, 1]",-55,-3432,"[-1, -1, -10, -10, -10, -10, -10, -10, -10, -10]","[0, 2, 1, 1, 1, 1, 1, 1, 1, 1]",-82,-3531,"[-10, -10, -10, -10, -10, -10, -10, -10, -10, -10]","[3, 3, 3, 3, 3, 3, 3, 3, 3, 3]",-100,-3504,"[-10, -10, -10, -10, -10, -10, -10, -10, -10, -10]","[2, 2, 2, 2, 2, 2, 2, 2, 2, 2]",-100,-3594,"[-10, -10, -10, -10, -10, -10, -10, -10, -10, -10]","[3, 3, 3, 3, 3, 3, 3, 3, 3, 3]",-100,-3450
"[-10, -10, -10, -10, -10, -10, -10, -10, -10, -10]","[3, 3, 3, 3, 3, 3, 3, 3, 3, 3]",-100,-3532,"[-1, -1, -1, -10, -10, -10, -10, -10, -10, -10]","[0, 2, 2, 1, 1, 1, 1, 1, 1, 1]",-73,-3604,"[-10, -10, -10, -10, -10, -10, -10, -10, -10, -10]","[3, 3, 3, 3, 3, 3, 3, 3, 3, 3]",-100,-3604,"[-10, -10, -10, -10, -10, -10, -10, -10, -10, -10]","[3, 3, 3, 3, 3, 3, 3, 3, 3, 3]",-100,-3694,"[-1, -1, -10, -10, -10, -10, -10, -10, -10, -10]","[0, 2, 1, 1, 1, 1, 1, 1, 1, 1]",-82,-3532
"[-1, -1, -1, -1, -10, -10, -10, -10, -10, -10]","[0, 2, 1, 5, 1, 1, 1, 1, 1, 1]",-64,-3596,"[-10, -10, -10, -10, -10, -10, -10, -10, -10, -10]","[3, 3, 3, 3, 3, 3, 3, 3, 3, 3]",-100,-3704,"[-10, -10, -10, -10, -10, -10, -10, -10, -10, -10]","[2, 2, 2, 2, 2, 2, 2, 2, 2, 2]",-100,-3704,"[-10, -10, -10, -10, -10, -10, -10, -10, -10, -10]","[3, 3, 3, 3, 3, 3, 3, 3, 3, 3]",-100,-3794,"[-10, -10, -10, -10, -10, -10, -10, -10, -10, -10]","[3, 3, 3, 3, 3, 3, 3, 3, 3, 3]",-100,-3632
"[-1, -1, -10, -10, -10, -10, -10, -10, -10, -10]","[0, 2, 1, 1, 1, 1, 1, 1, 1, 1]",-82,-3678,"[-1, -10, -10, -10, -10, -10, -10, -10, -10, -10]","[0, 1, 1, 1, 1, 1, 1, 1, 1, 1]",-91,-3795,"[-10, -10, -10, -10, -10, -10, -10, -10, -10, -10]","[2, 2, 2, 2, 2, 2, 2, 2, 2, 2]",-100,-3804,"[-10, -10, -10, -10, -10, -10, -10, -10, -10, -10]","[3, 3, 3, 3, 3, 3, 3, 3, 3, 3]",-100,-3894,"[-10, -10, -10, -10, -10, -10, -10, -10, -10, -10]","[2, 2, 2, 2, 2, 2, 2, 2, 2, 2]",-100,-3732
"[-10, -10, -10, -10, -10, -10, -10, -10, -10, -10]","[3, 3, 3, 3, 3, 3, 3, 3, 3, 3]",-100,-3778,"[-1, -1, -10, -10, -10, -10, -10, -10, -10, -10]","[0, 2, 1, 1, 1, 1, 1, 1, 1, 1]",-82,-3877,"[-10, -10, -10, -10, -10, -10, -10, -10, -10, -10]","[2, 2, 2, 2, 2, 2, 2, 2, 2, 2]",-100,-3904,"[-1, -1, -10, -10, -10, -10, -10, -10, -10, -10]","[0, 2, 1, 1, 1, 1, 1, 1, 1, 1]",-82,-3976,"[-10, -10, -10, -10, -10, -10, -10, -10, -10, -10]","[3, 3, 3, 3, 3, 3, 3, 3, 3, 3]",-100,-3832
"[-10, -10, -10, -10, -10, -10, -10, -10, -10, -10]","[2, 2, 2, 2, 2, 2, 2, 2, 2, 2]",-100,-3878,"[-10, -10, -10, -10, -10, -10, -10, -10, -10, -10]","[2, 2, 2, 2, 2, 2, 2, 2, 2, 2]",-100,-3977,"[-10, -10, -10, -10, -10, -10, -10, -10, -10, -10]","[2, 2, 2, 2, 2, 2, 2, 2, 2, 2]",-100,-4004,"[-1, -1, -1, -1, -10, -10, -10, -10, -10, -10]","[0, 2, 1, 5, 1, 1, 1, 1, 1, 1]",-64,-4040,"[-10, -10, -10, -10, -10, -10, -10, -10, -10, -10]","[3, 3, 3, 3, 3, 3, 3, 3, 3, 3]",-100,-3932
"[-10, -10, -10, -10, -10, -10, -10, -10, -10, -10]","[2, 2, 2, 2, 2, 2, 2, 2, 2, 2]",-100,-3978,"[-10, -10, -10, -10, -10, -10, -10, -10, -10, -10]","[3, 3, 3, 3, 3, 3, 3, 3, 3, 3]",-100,-4077,"[-10, -10, -10, -10, -10, -10, -10, -10, -10, -10]","[3, 3, 3, 3, 3, 3, 3, 3, 3, 3]",-100,-4104,"[-1, -10, -10, -10, -10, -10, -10, -10, -10, -10]","[0, 1, 1, 1, 1, 1, 1, 1, 1, 1]",-91,-4131,"[-10, -10, -10, -10, -10, -10, -10, -10, -10, -10]","[3, 3, 3, 3, 3, 3, 3, 3, 3, 3]",-100,-4032
"[-1, -1, -1, -10, -10, -10, -10, -10, -10, -10]","[0, 2, 2, 1, 1, 1, 1, 1, 1, 1]",-73,-4051,"[-1, -1, -1, -10, -10, -10, -10, -10, -10, -10]","[0, 2, 2, 1, 1, 1, 1, 1, 1, 1]",-73,-4150,"[-1, -10, -10, -10, -10, -10, -10, -10, -10, -10]","[0, 1, 1, 1, 1, 1, 1, 1, 1, 1]",-91,-4195,"[-10, -10, -10, -10, -10, -10, -10, -10, -10, -10]","[3, 3, 3, 3, 3, 3, 3, 3, 3, 3]",-100,-4231,"[-10, -10, -10, -10, -10, -10, -10, -10, -10, -10]","[2, 2, 2, 2, 2, 2, 2, 2, 2, 2]",-100,-4132
"[-10, -10, -10, -10, -10, -10, -10, -10, -10, -10]","[3, 3, 3, 3, 3, 3, 3, 3, 3, 3]",-100,-4151,"[-1, -1, -1, -10, -10, -10, -10, -10, -10, -10]","[0, 2, 2, 1, 1, 1, 1, 1, 1, 1]",-73,-4223,"[-1, -1, -1, -10, -10, -10, -10, -10, -10, -10]","[0, 2, 2, 1, 1, 1, 1, 1, 1, 1]",-73,-4268,"[-10, -10, -10, -10, -10, -10, -10, -10, -10, -10]","[2, 2, 2, 2, 2, 2, 2, 2, 2, 2]",-100,-4331,"[-1, -10, -10, -10, -10, -10, -10, -10, -10, -10]","[0, 1, 1, 1, 1, 1, 1, 1, 1, 1]",-91,-4223
"[-10, -10, -10, -10, -10, -10, -10, -10, -10, -10]","[2, 2, 2, 2, 2, 2, 2, 2, 2, 2]",-100,-4251,"[-10, -10, -10, -10, -10, -10, -10, -10, -10, -10]","[2, 2, 2, 2, 2, 2, 2, 2, 2, 2]",-100,-4323,"[-1, -1, -10, -10, -10, -10, -10, -10, -10, -10]","[0, 2, 1, 1, 1, 1, 1, 1, 1, 1]",-82,-4350,"[-1, -1, -10, -10, -10, -10, -10, -10, -10, -10]","[0, 2, 1, 1, 1, 1, 1, 1, 1, 1]",-82,-4413,"[-10, -10, -10, -10, -10, -10, -10, -10, -10, -10]","[2, 2, 2, 2, 2, 2, 2, 2, 2, 2]",-100,-4323
"[-10, -10, -10, -10, -10, -10, -10, -10, -10, -10]","[2, 2, 2, 2, 2, 2, 2, 2, 2, 2]",-100,-4351,"[-10, -10, -10, -10, -10, -10, -10, -10, -10, -10]","[2, 2, 2, 2, 2, 2, 2, 2, 2, 2]",-100,-4423,"[-10, -10, -10, -10, -10, -10, -10, -10, -10, -10]","[3, 3, 3, 3, 3, 3, 3, 3, 3, 3]",-100,-4450,"[-10, -10, -10, -10, -10, -10, -10, -10, -10, -10]","[2, 2, 2, 2, 2, 2, 2, 2, 2, 2]",-100,-4513,"[-1, -1, -1, -10, -10, -10, -10, -10, -10, -10]","[0, 1, 5, 1, 1, 1, 1, 1, 1, 1]",-73,-4396
"[-1, -1, -1, -10, -10, -10, -10, -10, -10, -10]","[0, 2, 2, 1, 1, 1, 1, 1, 1, 1]",-73,-4424,"[-1, -1, -1, -1, -10, -10, -10, -10, -10, -10]","[0, 2, 1, 5, 1, 1, 1, 1, 1, 1]",-64,-4487,"[-1, -1, -1, -10, -10, -10, -10, -10, -10, -10]","[0, 1, 5, 1, 1, 1, 1, 1, 1, 1]",-73,-4523,"[-1, -1, -1, -1, -10, -10, -10, -10, -10, -10]","[0, 2, 1, 5, 1, 1, 1, 1, 1, 1]",-64,-4577,"[-1, -1, -1, -1, -10, -10, -10, -10, -10, -10]","[0, 3, 1, 5, 1, 1, 1, 1, 1, 1]",-64,-4460
"[-1, -1, -10, -10, -10, -10, -10, -10, -10, -10]","[0, 2, 1, 1, 1, 1, 1, 1, 1, 1]",-82,-4506,"[-1, -1, -1, -10, -10, -10, -10, -10, -10, -10]","[0, 2, 2, 1, 1, 1, 1, 1, 1, 1]",-73,-4560,"[-10, -10, -10, -10, -10, -10, -10, -10, -10, -10]","[2, 2, 2, 2, 2, 2, 2, 2, 2, 2]",-100,-4623,"[-10, -10, -10, -10, -10, -10, -10, -10, -10, -10]","[2, 2, 2, 2, 2, 2, 2, 2, 2, 2]",-100,-4677,"[-10, -10, -10, -10, -10, -10, -10, -10, -10, -10]","[3, 3, 3, 3, 3, 3, 3, 3, 3, 3]",-100,-4560
"[-10, -10, -10, -10, -10, -10, -10, -10, -10, -10]","[3, 3, 3, 3, 3, 3, 3, 3, 3, 3]",-100,-4606,"[-10, -10, -10, -10, -10, -10, -10, -10, -10, -10]","[2, 2, 2, 2, 2, 2, 2, 2, 2, 2]",-100,-4660,"[-10, -10, -10, -10, -10, -10, -10, -10, -10, -10]","[2, 2, 2, 2, 2, 2, 2, 2, 2, 2]",-100,-4723,"[-10, -10, -10, -10, -10, -10, -10, -10, -10, -10]","[2, 2, 2, 2, 2, 2, 2, 2, 2, 2]",-100,-4777,"[-10, -10, -10, -10, -10, -10, -10, -10, -10, -10]","[2, 2, 2, 2, 2, 2, 2, 2, 2, 2]",-100,-4660
"[-10, -10, -10, -10, -10, -10, -10, -10, -10, -10]","[2, 2, 2, 2, 2, 2, 2, 2, 2, 2]",-100,-4706,"[-1, -1, -1, -1, -1, -10, -10, -10, -10, -10]","[0, 2, 2, 1, 5, 1, 1, 1, 1, 1]",-55,-4715,"[-1, -1, -1, -10, -10, -10, -10, -10, -10, -10]","[0, 1, 5, 1, 1, 1, 1, 1, 1, 1]",-73,-4796,"[-1, -1, -10, -10, -10, -10, -10, -10, -10, -10]","[0, 2, 1, 1, 1, 1, 1, 1, 1, 1]",-82,-4859,"[-10, -10, -10, -10, -10, -10, -10, -10, -10, -10]","[3, 3, 3, 3, 3, 3, 3, 3, 3, 3]",-100,-4760
"[-10, -10, -10, -10, -10, -10, -10, -10, -10, -10]","[3, 3, 3, 3, 3, 3, 3, 3, 3, 3]",-100,-4806,"[-10, -10, -10, -10, -10, -10, -10, -10, -10, -10]","[2, 2, 2, 2, 2, 2, 2, 2, 2, 2]",-100,-4815,"[-10, -10, -10, -10, -10, -10, -10, -10, -10, -10]","[2, 2, 2, 2, 2, 2, 2, 2, 2, 2]",-100,-4896,"[-10, -10, -10, -10, -10, -10, -10, -10, -10, -10]","[2, 2, 2, 2, 2, 2, 2, 2, 2, 2]",-100,-4959,"[-10, -10, -10, -10, -10, -10, -10, -10, -10, -10]","[3, 3, 3, 3, 3, 3, 3, 3, 3, 3]",-100,-4860
"[-10, -10, -10, -10, -10, -10, -10, -10, -10, -10]","[2, 2, 2, 2, 2, 2, 2, 2, 2, 2]",-100,-4906,"[-10, -10, -10, -10, -10, -10, -10, -10, -10, -10]","[3, 3, 3, 3, 3, 3, 3, 3, 3, 3]",-100,-4915,"[-10, -10, -10, -10, -10, -10, -10, -10, -10, -10]","[2, 2, 2, 2, 2, 2, 2, 2, 2, 2]",-100,-4996,"[-10, -10, -10, -10, -10, -10, -10, -10, -10, -10]","[3, 3, 3, 3, 3, 3, 3, 3, 3, 3]",-100,-5059,"[-1, -1, -1, -1, -10, -10, -10, -10, -10, -10]","[0, 2, 1, 5, 1, 1, 1, 1, 1, 1]",-64,-4924
"[-10, -10, -10, -10, -10, -10, -10, -10, -10, -10]","[3, 3, 3, 3, 3, 3, 3, 3, 3, 3]",-100,-5006,"[-1, -1, -10, -10, -10, -10, -10, -10, -10, -10]","[0, 2, 1, 1, 1, 1, 1, 1, 1, 1]",-82,-4997,"[-1, -1, -1, -1, -1, -10, -10, -10, -10, -10]","[0, 2, 2, 1, 5, 1, 1, 1, 1, 1]",-55,-5051,"[-10, -10, -10, -10, -10, -10, -10, -10, -10, -10]","[2, 2, 2, 2, 2, 2, 2, 2, 2, 2]",-100,-5159,"[-10, -10, -10, -10, -10, -10, -10, -10, -10, -10]","[2, 2, 2, 2, 2, 2, 2, 2, 2, 2]",-100,-5024
"[-1, -1, -10, -10, -10, -10, -10, -10, -10, -10]","[0, 2, 1, 1, 1, 1, 1, 1, 1, 1]",-82,-5088,"[-10, -10, -10, -10, -10, -10, -10, -10, -10, -10]","[2, 2, 2, 2, 2, 2, 2, 2, 2, 2]",-100,-5097,"[-1, -1, -1, -1, -1, -10, -10, -10, -10, -10]","[0, 2, 2, 1, 5, 1, 1, 1, 1, 1]",-55,-5106,"[-10, -10, -10, -10, -10, -10, -10, -10, -10, -10]","[2, 2, 2, 2, 2, 2, 2, 2, 2, 2]",-100,-5259,"[-1, -1, -1, -1, -10, -10, -10, -10, -10, -10]","[0, 2, 1, 5, 1, 1, 1, 1, 1, 1]",-64,-5088
"[-10, -10, -10, -10, -10, -10, -10, -10, -10, -10]","[2, 2, 2, 2, 2, 2, 2, 2, 2, 2]",-100,-5188,"[-10, -10, -10, -10, -10, -10, -10, -10, -10, -10]","[3, 3, 3, 3, 3, 3, 3, 3, 3, 3]",-100,-5197,"[-10, -10, -10, -10, -10, -10, -10, -10, -10, -10]","[2, 2, 2, 2, 2, 2, 2, 2, 2, 2]",-100,-5206,"[-10, -10, -10, -10, -10, -10, -10, -10, -10, -10]","[3, 3, 3, 3, 3, 3, 3, 3, 3, 3]",-100,-5359,"[-10, -10, -10, -10, -10, -10, -10, -10, -10, -10]","[2, 2, 2, 2, 2, 2, 2, 2, 2, 2]",-100,-5188
"[-10, -10, -10, -10, -10, -10, -10, -10, -10, -10]","[2, 2, 2, 2, 2, 2, 2, 2, 2, 2]",-100,-5288,"[-10, -10, -10, -10, -10, -10, -10, -10, -10, -10]","[2, 2, 2, 2, 2, 2, 2, 2, 2, 2]",-100,-5297,"[-10, -10, -10, -10, -10, -10, -10, -10, -10, -10]","[2, 2, 2, 2, 2, 2, 2, 2, 2, 2]",-100,-5306,"[-10, -10, -10, -10, -10, -10, -10, -10, -10, -10]","[2, 2, 2, 2, 2, 2, 2, 2, 2, 2]",-100,-5459,"[-10, -10, -10, -10, -10, -10, -10, -10, -10, -10]","[3, 3, 3, 3, 3, 3, 3, 3, 3, 3]",-100,-5288
"[-1, -10, -10, -10, -10, -10, -10, -10, -10, -10]","[0, 1, 1, 1, 1, 1, 1, 1, 1, 1]",-91,-5379,"[-10, -10, -10, -10, -10, -10, -10, -10, -10, -10]","[3, 3, 3, 3, 3, 3, 3, 3, 3, 3]",-100,-5397,"[-10, -10, -10, -10, -10, -10, -10, -10, -10, -10]","[3, 3, 3, 3, 3, 3, 3, 3, 3, 3]",-100,-5406,"[-10, -10, -10, -10, -10, -10, -10, -10, -10, -10]","[2, 2, 2, 2, 2, 2, 2, 2, 2, 2]",-100,-5559,"[-10, -10, -10, -10, -10, -10, -10, -10, -10, -10]","[2, 2, 2, 2, 2, 2, 2, 2, 2, 2]",-100,-5388
"[-10, -10, -10, -10, -10, -10, -10, -10, -10, -10]","[2, 2, 2, 2, 2, 2, 2, 2, 2, 2]",-100,-5479,"[-10, -10, -10, -10, -10, -10, -10, -10, -10, -10]","[2, 2, 2, 2, 2, 2, 2, 2, 2, 2]",-100,-5497,"[-10, -10, -10, -10, -10, -10, -10, -10, -10, -10]","[2, 2, 2, 2, 2, 2, 2, 2, 2, 2]",-100,-5506,"[-1, -1, -10, -10, -10, -10, -10, -10, -10, -10]","[0, 2, 1, 1, 1, 1, 1, 1, 1, 1]",-82,-5641,"[-10, -10, -10, -10, -10, -10, -10, -10, -10, -10]","[3, 3, 3, 3, 3, 3, 3, 3, 3, 3]",-100,-5488
"[-1, -1, -1, -1, -1, -10, -10, -10, -10, -10]","[0, 2, 2, 1, 5, 1, 1, 1, 1, 1]",-55,-5534,"[-10, -10, -10, -10, -10, -10, -10, -10, -10, -10]","[3, 3, 3, 3, 3, 3, 3, 3, 3, 3]",-100,-5597,"[-1, -1, -1, -10, -10, -10, -10, -10, -10, -10]","[0, 2, 2, 1, 1, 1, 1, 1, 1, 1]",-73,-5579,"[-10, -10, -10, -10, -10, -10, -10, -10, -10, -10]","[2, 2, 2, 2, 2, 2, 2, 2, 2, 2]",-100,-5741,"[-10, -10, -10, -10, -10, -10, -10, -10, -10, -10]","[2, 2, 2, 2, 2, 2, 2, 2, 2, 2]",-100,-5588
"[-10, -10, -10, -10, -10, -10, -10, -10, -10, -10]","[3, 3, 3, 3, 3, 3, 3, 3, 3, 3]",-100,-5634,"[-10, -10, -10, -10, -10, -10, -10, -10, -10, -10]","[2, 2, 2, 2, 2, 2, 2, 2, 2, 2]",-100,-5697,"[-10, -10, -10, -10, -10, -10, -10, -10, -10, -10]","[2, 2, 2, 2, 2, 2, 2, 2, 2, 2]",-100,-5679,"[-1, -1, -1, -1, -10, -10, -10, -10, -10, -10]","[0, 2, 1, 5, 1, 1, 1, 1, 1, 1]",-64,-5805,"[-1, -10, -10, -10, -10, -10, -10, -10, -10, -10]","[0, 1, 1, 1, 1, 1, 1, 1, 1, 1]",-91,-5679
"[-10, -10, -10, -10, -10, -10, -10, -10, -10, -10]","[2, 2, 2, 2, 2, 2, 2, 2, 2, 2]",-100,-5734,"[-1, -10, -10, -10, -10, -10, -10, -10, -10, -10]","[0, 1, 1, 1, 1, 1, 1, 1, 1, 1]",-91,-5788,"[-10, -10, -10, -10, -10, -10, -10, -10, -10, -10]","[2, 2, 2, 2, 2, 2, 2, 2, 2, 2]",-100,-5779,"[-1, -1, -1, -10, -10, -10, -10, -10, -10, -10]","[0, 1, 5, 1, 1, 1, 1, 1, 1, 1]",-73,-5878,"[-10, -10, -10, -10, -10, -10, -10, -10, -10, -10]","[3, 3, 3, 3, 3, 3, 3, 3, 3, 3]",-100,-5779
"[-10, -10, -10, -10, -10, -10, -10, -10, -10, -10]","[3, 3, 3, 3, 3, 3, 3, 3, 3, 3]",-100,-5834,"[-1, -1, -10, -10, -10, -10, -10, -10, -10, -10]","[0, 2, 1, 1, 1, 1, 1, 1, 1, 1]",-82,-5870,"[-10, -10, -10, -10, -10, -10, -10, -10, -10, -10]","[2, 2, 2, 2, 2, 2, 2, 2, 2, 2]",-100,-5879,"[-1, -1, -1, -10, -10, -10, -10, -10, -10, -10]","[0, 2, 2, 1, 1, 1, 1, 1, 1, 1]",-73,-5951,"[-1, -1, -10, -10, -10, -10, -10, -10, -10, -10]","[0, 2, 1, 1, 1, 1, 1, 1, 1, 1]",-82,-5861
"[-10, -10, -10, -10, -10, -10, -10, -10, -10, -10]","[3, 3, 3, 3, 3, 3, 3, 3, 3, 3]",-100,-5934,"[-10, -10, -10, -10, -10, -10, -10, -10, -10, -10]","[2, 2, 2, 2, 2, 2, 2, 2, 2, 2]",-100,-5970,"[-10, -10, -10, -10, -10, -10, -10, -10, -10, -10]","[3, 3, 3, 3, 3, 3, 3, 3, 3, 3]",-100,-5979,"[-10, -10, -10, -10, -10, -10, -10, -10, -10, -10]","[2, 2, 2, 2, 2, 2, 2, 2, 2, 2]",-100,-6051,"[-1, -1, -1, -1, -1, -10, -10, -10, -10, -10]","[0, 2, 2, 1, 5, 1, 1, 1, 1, 1]",-55,-5916
"[-1, -1, -1, -10, -10, -10, -10, -10, -10, -10]","[0, 2, 2, 1, 1, 1, 1, 1, 1, 1]",-73,-6007,"[-10, -10, -10, -10, -10, -10, -10, -10, -10, -10]","[3, 3, 3, 3, 3, 3, 3, 3, 3, 3]",-100,-6070,"[-10, -10, -10, -10, -10, -10, -10, -10, -10, -10]","[3, 3, 3, 3, 3, 3, 3, 3, 3, 3]",-100,-6079,"[-10, -10, -10, -10, -10, -10, -10, -10, -10, -10]","[2, 2, 2, 2, 2, 2, 2, 2, 2, 2]",-100,-6151,"[-10, -10, -10, -10, -10, -10, -10, -10, -10, -10]","[2, 2, 2, 2, 2, 2, 2, 2, 2, 2]",-100,-6016
"[-10, -10, -10, -10, -10, -10, -10, -10, -10, -10]","[2, 2, 2, 2, 2, 2, 2, 2, 2, 2]",-100,-6107,"[-10, -10, -10, -10, -10, -10, -10, -10, -10, -10]","[2, 2, 2, 2, 2, 2, 2, 2, 2, 2]",-100,-6170,"[-10, -10, -10, -10, -10, -10, -10, -10, -10, -10]","[3, 3, 3, 3, 3, 3, 3, 3, 3, 3]",-100,-6179,"[-10, -10, -10, -10, -10, -10, -10, -10, -10, -10]","[2, 2, 2, 2, 2, 2, 2, 2, 2, 2]",-100,-6251,"[-10, -10, -10, -10, -10, -10, -10, -10, -10, -10]","[2, 2, 2, 2, 2, 2, 2, 2, 2, 2]",-100,-6116
"[-1, -10, -10, -10, -10, -10, -10, -10, -10, -10]","[0, 1, 1, 1, 1, 1, 1, 1, 1, 1]",-91,-6198,"[-10, -10, -10, -10, -10, -10, -10, -10, -10, -10]","[2, 2, 2, 2, 2, 2, 2, 2, 2, 2]",-100,-6270,"[-1, -1, -1, -10, -10, -10, -10, -10, -10, -10]","[0, 2, 2, 1, 1, 1, 1, 1, 1, 1]",-73,-6252,"[-1, -1, -1, -10, -10, -10, -10, -10, -10, -10]","[0, 2, 2, 1, 1, 1, 1, 1, 1, 1]",-73,-6324,"[-10, -10, -10, -10, -10, -10, -10, -10, -10, -10]","[3, 3, 3, 3, 3, 3, 3, 3, 3, 3]",-100,-6216
"[-1, -1, -1, -10, -10, -10, -10, -10, -10, -10]","[0, 2, 2, 1, 1, 1, 1, 1, 1, 1]",-73,-6271,"[-1, -10, -10, -10, -10, -10, -10, -10, -10, -10]","[0, 1, 1, 1, 1, 1, 1, 1, 1, 1]",-91,-6361,"[-10, -10, -10, -10, -10, -10, -10, -10, -10, -10]","[3, 3, 3, 3, 3, 3, 3, 3, 3, 3]",-100,-6352,"[-10, -10, -10, -10, -10, -10, -10, -10, -10, -10]","[2, 2, 2, 2, 2, 2, 2, 2, 2, 2]",-100,-6424,"[-1, -10, -10, -10, -10, -10, -10, -10, -10, -10]","[0, 1, 1, 1, 1, 1, 1, 1, 1, 1]",-91,-6307
"[-10, -10, -10, -10, -10, -10, -10, -10, -10, -10]","[2, 2, 2, 2, 2, 2, 2, 2, 2, 2]",-100,-6371,"[-10, -10, -10, -10, -10, -10, -10, -10, -10, -10]","[3, 3, 3, 3, 3, 3, 3, 3, 3, 3]",-100,-6461,"[-10, -10, -10, -10, -10, -10, -10, -10, -10, -10]","[3, 3, 3, 3, 3, 3, 3, 3, 3, 3]",-100,-6452,"[-10, -10, -10, -10, -10, -10, -10, -10, -10, -10]","[3, 3, 3, 3, 3, 3, 3, 3, 3, 3]",-100,-6524,"[-1, -1, -10, -10, -10, -10, -10, -10, -10, -10]","[0, 2, 1, 1, 1, 1, 1, 1, 1, 1]",-82,-6389
"[-1, -1, -1, -10, -10, -10, -10, -10, -10, -10]","[0, 2, 2, 1, 1, 1, 1, 1, 1, 1]",-73,-6444,"[-10, -10, -10, -10, -10, -10, -10, -10, -10, -10]","[3, 3, 3, 3, 3, 3, 3, 3, 3, 3]",-100,-6561,"[-10, -10, -10, -10, -10, -10, -10, -10, -10, -10]","[3, 3, 3, 3, 3, 3, 3, 3, 3, 3]",-100,-6552,"[-10, -10, -10, -10, -10, -10, -10, -10, -10, -10]","[3, 3, 3, 3, 3, 3, 3, 3, 3, 3]",-100,-6624,"[-1, -1, -1, -1, -10, -10, -10, -10, -10, -10]","[0, 2, 1, 5, 1, 1, 1, 1, 1, 1]",-64,-6453
"[-1, -1, -1, -10, -10, -10, -10, -10, -10, -10]","[0, 2, 2, 1, 1, 1, 1, 1, 1, 1]",-73,-6517,"[-1, -1, -10, -10, -10, -10, -10, -10, -10, -10]","[0, 2, 1, 1, 1, 1, 1, 1, 1, 1]",-82,-6643,"[-10, -10, -10, -10, -10, -10, -10, -10, -10, -10]","[2, 2, 2, 2, 2, 2, 2, 2, 2, 2]",-100,-6652,"[-1, -1, -10, -10, -10, -10, -10, -10, -10, -10]","[0, 2, 1, 1, 1, 1, 1, 1, 1, 1]",-82,-6706,"[-10, -10, -10, -10, -10, -10, -10, -10, -10, -10]","[3, 3, 3, 3, 3, 3, 3, 3, 3, 3]",-100,-6553
"[-1, -1, -10, -10, -10, -10, -10, -10, -10, -10]","[0, 2, 1, 1, 1, 1, 1, 1, 1, 1]",-82,-6599,"[-10, -10, -10, -10, -10, -10, -10, -10, -10, -10]","[3, 3, 3, 3, 3, 3, 3, 3, 3, 3]",-100,-6743,"[-1, -1, -1, -1, -1, -10, -10, -10, -10, -10]","[0, 2, 2, 1, 5, 1, 1, 1, 1, 1]",-55,-6707,"[-10, -10, -10, -10, -10, -10, -10, -10, -10, -10]","[2, 2, 2, 2, 2, 2, 2, 2, 2, 2]",-100,-6806,"[-10, -10, -10, -10, -10, -10, -10, -10, -10, -10]","[3, 3, 3, 3, 3, 3, 3, 3, 3, 3]",-100,-6653
"[-10, -10, -10, -10, -10, -10, -10, -10, -10, -10]","[3, 3, 3, 3, 3, 3, 3, 3, 3, 3]",-100,-6699,"[-1, -1, -10, -10, -10, -10, -10, -10, -10, -10]","[0, 2, 1, 1, 1, 1, 1, 1, 1, 1]",-82,-6825,"[-10, -10, -10, -10, -10, -10, -10, -10, -10, -10]","[2, 2, 2, 2, 2, 2, 2, 2, 2, 2]",-100,-6807,"[-10, -10, -10, -10, -10, -10, -10, -10, -10, -10]","[3, 3, 3, 3, 3, 3, 3, 3, 3, 3]",-100,-6906,"[-1, -1, -10, -10, -10, -10, -10, -10, -10, -10]","[0, 2, 1, 1, 1, 1, 1, 1, 1, 1]",-82,-6735
"[-1, -1, -1, -1, -1, -10, -10, -10, -10, -10]","[0, 2, 2, 1, 5, 1, 1, 1, 1, 1]",-55,-6754,"[-10, -10, -10, -10, -10, -10, -10, -10, -10, -10]","[3, 3, 3, 3, 3, 3, 3, 3, 3, 3]",-100,-6925,"[-10, -10, -10, -10, -10, -10, -10, -10, -10, -10]","[3, 3, 3, 3, 3, 3, 3, 3, 3, 3]",-100,-6907,"[-1, -1, -1, -10, -10, -10, -10, -10, -10, -10]","[0, 2, 2, 1, 1, 1, 1, 1, 1, 1]",-73,-6979,"[-10, -10, -10, -10, -10, -10, -10, -10, -10, -10]","[3, 3, 3, 3, 3, 3, 3, 3, 3, 3]",-100,-6835
"[-1, -1, -1, -1, -10, -10, -10, -10, -10, -10]","[0, 2, 1, 5, 1, 1, 1, 1, 1, 1]",-64,-6818,"[-1, -1, -1, -1, -10, -10, -10, -10, -10, -10]","[0, 3, 1, 5, 1, 1, 1, 1, 1, 1]",-64,-6989,"[-1, -1, -1, -10, -10, -10, -10, -10, -10, -10]","[0, 2, 2, 1, 1, 1, 1, 1, 1, 1]",-73,-6980,"[-1, -1, -10, -10, -10, -10, -10, -10, -10, -10]","[0, 2, 1, 1, 1, 1, 1, 1, 1, 1]",-82,-7061,"[-10, -10, -10, -10, -10, -10, -10, -10, -10, -10]","[3, 3, 3, 3, 3, 3, 3, 3, 3, 3]",-100,-6935
"[-10, -10, -10, -10, -10, -10, -10, -10, -10, -10]","[2, 2, 2, 2, 2, 2, 2, 2, 2, 2]",-100,-6918,"[-1, -1, -1, -10, -10, -10, -10, -10, -10, -10]","[0, 2, 2, 1, 1, 1, 1, 1, 1, 1]",-73,-7062,"[-1, -1, -1, -1, -1, -10, -10, -10, -10, -10]","[0, 2, 2, 1, 5, 1, 1, 1, 1, 1]",-55,-7035,"[-10, -10, -10, -10, -10, -10, -10, -10, -10, -10]","[2, 2, 2, 2, 2, 2, 2, 2, 2, 2]",-100,-7161,"[-10, -10, -10, -10, -10, -10, -10, -10, -10, -10]","[3, 3, 3, 3, 3, 3, 3, 3, 3, 3]",-100,-7035
"[-10, -10, -10, -10, -10, -10, -10, -10, -10, -10]","[3, 3, 3, 3, 3, 3, 3, 3, 3, 3]",-100,-7018,"[-1, -1, -1, -10, -10, -10, -10, -10, -10, -10]","[0, 2, 2, 1, 1, 1, 1, 1, 1, 1]",-73,-7135,"[-1, -1, -1, -10, -10, -10, -10, -10, -10, -10]","[0, 2, 2, 1, 1, 1, 1, 1, 1, 1]",-73,-7108,"[-10, -10, -10, -10, -10, -10, -10, -10, -10, -10]","[2, 2, 2, 2, 2, 2, 2, 2, 2, 2]",-100,-7261,"[-10, -10, -10, -10, -10, -10, -10, -10, -10, -10]","[2, 2, 2, 2, 2, 2, 2, 2, 2, 2]",-100,-7135
"[-1, -1, -1, -10, -10, -10, -10, -10, -10, -10]","[0, 1, 5, 1, 1, 1, 1, 1, 1, 1]",-73,-7091,"[-1, -1, -1, -10, -10, -10, -10, -10, -10, -10]","[0, 2, 2, 1, 1, 1, 1, 1, 1, 1]",-73,-7208,"[-1, -1, -1, -1, -10, -10, -10, -10, -10, -10]","[0, 3, 1, 5, 1, 1, 1, 1, 1, 1]",-64,-7172,"[-10, -10, -10, -10, -10, -10, -10, -10, -10, -10]","[2, 2, 2, 2, 2, 2, 2, 2, 2, 2]",-100,-7361,"[-10, -10, -10, -10, -10, -10, -10, -10, -10, -10]","[3, 3, 3, 3, 3, 3, 3, 3, 3, 3]",-100,-7235
"[-10, -10, -10, -10, -10, -10, -10, -10, -10, -10]","[3, 3, 3, 3, 3, 3, 3, 3, 3, 3]",-100,-7191,"[-10, -10, -10, -10, -10, -10, -10, -10, -10, -10]","[3, 3, 3, 3, 3, 3, 3, 3, 3, 3]",-100,-7308,"[-1, -1, -1, -1, -10, -10, -10, -10, -10, -10]","[0, 2, 1, 5, 1, 1, 1, 1, 1, 1]",-64,-7236,"[-10, -10, -10, -10, -10, -10, -10, -10, -10, -10]","[2, 2, 2, 2, 2, 2, 2, 2, 2, 2]",-100,-7461,"[-10, -10, -10, -10, -10, -10, -10, -10, -10, -10]","[2, 2, 2, 2, 2, 2, 2, 2, 2, 2]",-100,-7335
"[-10, -10, -10, -10, -10, -10, -10, -10, -10, -10]","[2, 2, 2, 2, 2, 2, 2, 2, 2, 2]",-100,-7291,"[-10, -10, -10, -10, -10, -10, -10, -10, -10, -10]","[2, 2, 2, 2, 2, 2, 2, 2, 2, 2]",-100,-7408,"[-10, -10, -10, -10, -10, -10, -10, -10, -10, -10]","[2, 2, 2, 2, 2, 2, 2, 2, 2, 2]",-100,-7336,"[-10, -10, -10, -10, -10, -10, -10, -10, -10, -10]","[3, 3, 3, 3, 3, 3, 3, 3, 3, 3]",-100,-7561,"[-10, -10, -10, -10, -10, -10, -10, -10, -10, -10]","[3, 3, 3, 3, 3, 3, 3, 3, 3, 3]",-100,-7435
"[-1, -1, -10, -10, -10, -10, -10, -10, -10, -10]","[0, 2, 1, 1, 1, 1, 1, 1, 1, 1]",-82,-7373,"[-10, -10, -10, -10, -10, -10, -10, -10, -10, -10]","[2, 2, 2, 2, 2, 2, 2, 2, 2, 2]",-100,-7508,"[-1, -1, -1, -10, -10, -10, -10, -10, -10, -10]","[0, 2, 2, 1, 1, 1, 1, 1, 1, 1]",-73,-7409,"[-10, -10, -10, -10, -10, -10, -10, -10, -10, -10]","[2, 2, 2, 2, 2, 2, 2, 2, 2, 2]",-100,-7661,"[-10, -10, -10, -10, -10, -10, -10, -10, -10, -10]","[2, 2, 2, 2, 2, 2, 2, 2, 2, 2]",-100,-7535
"[-10, -10, -10, -10, -10, -10, -10, -10, -10, -10]","[2, 2, 2, 2, 2, 2, 2, 2, 2, 2]",-100,-7473,"[-10, -10, -10, -10, -10, -10, -10, -10, -10, -10]","[3, 3, 3, 3, 3, 3, 3, 3, 3, 3]",-100,-7608,"[-1, -1, -10, -10, -10, -10, -10, -10, -10, -10]","[0, 2, 1, 1, 1, 1, 1, 1, 1, 1]",-82,-7491,"[-10, -10, -10, -10, -10, -10, -10, -10, -10, -10]","[2, 2, 2, 2, 2, 2, 2, 2, 2, 2]",-100,-7761,"[-10, -10, -10, -10, -10, -10, -10, -10, -10, -10]","[2, 2, 2, 2, 2, 2, 2, 2, 2, 2]",-100,-7635
"[-1, -1, -10, -10, -10, -10, -10, -10, -10, -10]","[0, 2, 1, 1, 1, 1, 1, 1, 1, 1]",-82,-7555,"[-10, -10, -10, -10, -10, -10, -10, -10, -10, -10]","[2, 2, 2, 2, 2, 2, 2, 2, 2, 2]",-100,-7708,"[-10, -10, -10, -10, -10, -10, -10, -10, -10, -10]","[3, 3, 3, 3, 3, 3, 3, 3, 3, 3]",-100,-7591,"[-1, -1, -1, -10, -10, -10, -10, -10, -10, -10]","[0, 1, 5, 1, 1, 1, 1, 1, 1, 1]",-73,-7834,"[-1, -1, -10, -10, -10, -10, -10, -10, -10, -10]","[0, 2, 1, 1, 1, 1, 1, 1, 1, 1]",-82,-7717
"[-10, -10, -10, -10, -10, -10, -10, -10, -10, -10]","[3, 3, 3, 3, 3, 3, 3, 3, 3, 3]",-100,-7655,"[-10, -10, -10, -10, -10, -10, -10, -10, -10, -10]","[3, 3, 3, 3, 3, 3, 3, 3, 3, 3]",-100,-7808,"[-10, -10, -10, -10, -10, -10, -10, -10, -10, -10]","[2, 2, 2, 2, 2, 2, 2, 2, 2, 2]",-100,-7691,"[-1, -1, -10, -10, -10, -10, -10, -10, -10, -10]","[0, 2, 1, 1, 1, 1, 1, 1, 1, 1]",-82,-7916,"[-10, -10, -10, -10, -10, -10, -10, -10, -10, -10]","[2, 2, 2, 2, 2, 2, 2, 2, 2, 2]",-100,-7817
"[-10, -10, -10, -10, -10, -10, -10, -10, -10, -10]","[2, 2, 2, 2, 2, 2, 2, 2, 2, 2]",-100,-7755,"[-1, -1, -1, -10, -10, -10, -10, -10, -10, -10]","[0, 2, 2, 1, 1, 1, 1, 1, 1, 1]",-73,-7881,"[-10, -10, -10, -10, -10, -10, -10, -10, -10, -10]","[2, 2, 2, 2, 2, 2, 2, 2, 2, 2]",-100,-7791,"[-10, -10, -10, -10, -10, -10, -10, -10, -10, -10]","[2, 2, 2, 2, 2, 2, 2, 2, 2, 2]",-100,-8016,"[-1, -1, -10, -10, -10, -10, -10, -10, -10, -10]","[0, 2, 1, 1, 1, 1, 1, 1, 1, 1]",-82,-7899
"[-10, -10, -10, -10, -10, -10, -10, -10, -10, -10]","[3, 3, 3, 3, 3, 3, 3, 3, 3, 3]",-100,-7855,"[-1, -1, -10, -10, -10, -10, -10, -10, -10, -10]","[0, 2, 1, 1, 1, 1, 1, 1, 1, 1]",-82,-7963,"[-10, -10, -10, -10, -10, -10, -10, -10, -10, -10]","[3, 3, 3, 3, 3, 3, 3, 3, 3, 3]",-100,-7891,"[-10, -10, -10, -10, -10, -10, -10, -10, -10, -10]","[3, 3, 3, 3, 3, 3, 3, 3, 3, 3]",-100,-8116,"[-10, -10, -10, -10, -10, -10, -10, -10, -10, -10]","[2, 2, 2, 2, 2, 2, 2, 2, 2, 2]",-100,-7999
"[-10, -10, -10, -10, -10, -10, -10, -10, -10, -10]","[2, 2, 2, 2, 2, 2, 2, 2, 2, 2]",-100,-7955,"[-1, -1, -1, -1, -10, -10, -10, -10, -10, -10]","[0, 2, 1, 5, 1, 1, 1, 1, 1, 1]",-64,-8027,"[-1, -10, -10, -10, -10, -10, -10, -10, -10, -10]","[0, 1, 1, 1, 1, 1, 1, 1, 1, 1]",-91,-7982,"[-1, -1, -1, -1, -1, -10, -10, -10, -10, -10]","[0, 2, 2, 1, 5, 1, 1, 1, 1, 1]",-55,-8171,"[-10, -10, -10, -10, -10, -10, -10, -10, -10, -10]","[3, 3, 3, 3, 3, 3, 3, 3, 3, 3]",-100,-8099
"[-1, -1, -1, -1, -10, -10, -10, -10, -10, -10]","[0, 2, 1, 5, 1, 1, 1, 1, 1, 1]",-64,-8019,"[-10, -10, -10, -10, -10, -10, -10, -10, -10, -10]","[2, 2, 2, 2, 2, 2, 2, 2, 2, 2]",-100,-8127,"[-10, -10, -10, -10, -10, -10, -10, -10, -10, -10]","[2, 2, 2, 2, 2, 2, 2, 2, 2, 2]",-100,-8082,"[-10, -10, -10, -10, -10, -10, -10, -10, -10, -10]","[2, 2, 2, 2, 2, 2, 2, 2, 2, 2]",-100,-8271,"[-10, -10, -10, -10, -10, -10, -10, -10, -10, -10]","[2, 2, 2, 2, 2, 2, 2, 2, 2, 2]",-100,-8199
"[-1, -1, -1, -10, -10, -10, -10, -10, -10, -10]","[0, 2, 2, 1, 1, 1, 1, 1, 1, 1]",-73,-8092,"[-10, -10, -10, -10, -10, -10, -10, -10, -10, -10]","[2, 2, 2, 2, 2, 2, 2, 2, 2, 2]",-100,-8227,"[-10, -10, -10, -10, -10, -10, -10, -10, -10, -10]","[3, 3, 3, 3, 3, 3, 3, 3, 3, 3]",-100,-8182,"[-10, -10, -10, -10, -10, -10, -10, -10, -10, -10]","[3, 3, 3, 3, 3, 3, 3, 3, 3, 3]",-100,-8371,"[-10, -10, -10, -10, -10, -10, -10, -10, -10, -10]","[3, 3, 3, 3, 3, 3, 3, 3, 3, 3]",-100,-8299
"[-1, -1, -10, -10, -10, -10, -10, -10, -10, -10]","[0, 2, 1, 1, 1, 1, 1, 1, 1, 1]",-82,-8174,"[-10, -10, -10, -10, -10, -10, -10, -10, -10, -10]","[2, 2, 2, 2, 2, 2, 2, 2, 2, 2]",-100,-8327,"[-10, -10, -10, -10, -10, -10, -10, -10, -10, -10]","[2, 2, 2, 2, 2, 2, 2, 2, 2, 2]",-100,-8282,"[-1, -1, -10, -10, -10, -10, -10, -10, -10, -10]","[0, 2, 1, 1, 1, 1, 1, 1, 1, 1]",-82,-8453,"[-1, -1, -1, -10, -10, -10, -10, -10, -10, -10]","[0, 2, 2, 1, 1, 1, 1, 1, 1, 1]",-73,-8372
"[-1, -1, -1, -10, -10, -10, -10, -10, -10, -10]","[0, 2, 2, 1, 1, 1, 1, 1, 1, 1]",-73,-8247,"[-1, -1, -10, -10, -10, -10, -10, -10, -10, -10]","[0, 2, 1, 1, 1, 1, 1, 1, 1, 1]",-82,-8409,"[-1, -1, -10, -10, -10, -10, -10, -10, -10, -10]","[0, 2, 1, 1, 1, 1, 1, 1, 1, 1]",-82,-8364,"[-10, -10, -10, -10, -10, -10, -10, -10, -10, -10]","[3, 3, 3, 3, 3, 3, 3, 3, 3, 3]",-100,-8553,"[-10, -10, -10, -10, -10, -10, -10, -10, -10, -10]","[3, 3, 3, 3, 3, 3, 3, 3, 3, 3]",-100,-8472
"[-10, -10, -10, -10, -10, -10, -10, -10, -10, -10]","[2, 2, 2, 2, 2, 2, 2, 2, 2, 2]",-100,-8347,"[-10, -10, -10, -10, -10, -10, -10, -10, -10, -10]","[2, 2, 2, 2, 2, 2, 2, 2, 2, 2]",-100,-8509,"[-10, -10, -10, -10, -10, -10, -10, -10, -10, -10]","[2, 2, 2, 2, 2, 2, 2, 2, 2, 2]",-100,-8464,"[-1, -1, -1, -10, -10, -10, -10, -10, -10, -10]","[0, 2, 2, 1, 1, 1, 1, 1, 1, 1]",-73,-8626,"[-10, -10, -10, -10, -10, -10, -10, -10, -10, -10]","[2, 2, 2, 2, 2, 2, 2, 2, 2, 2]",-100,-8572
"[-1, -1, -10, -10, -10, -10, -10, -10, -10, -10]","[0, 2, 1, 1, 1, 1, 1, 1, 1, 1]",-82,-8429,"[-10, -10, -10, -10, -10, -10, -10, -10, -10, -10]","[3, 3, 3, 3, 3, 3, 3, 3, 3, 3]",-100,-8609,"[-1, -1, -10, -10, -10, -10, -10, -10, -10, -10]","[0, 2, 1, 1, 1, 1, 1, 1, 1, 1]",-82,-8546,"[-10, -10, -10, -10, -10, -10, -10, -10, -10, -10]","[3, 3, 3, 3, 3, 3, 3, 3, 3, 3]",-100,-8726,"[-1, -1, -10, -10, -10, -10, -10, -10, -10, -10]","[0, 2, 1, 1, 1, 1, 1, 1, 1, 1]",-82,-8654
"[-10, -10, -10, -10, -10, -10, -10, -10, -10, -10]","[3, 3, 3, 3, 3, 3, 3, 3, 3, 3]",-100,-8529,"[-10, -10, -10, -10, -10, -10, -10, -10, -10, -10]","[2, 2, 2, 2, 2, 2, 2, 2, 2, 2]",-100,-8709,"[-10, -10, -10, -10, -10, -10, -10, -10, -10, -10]","[2, 2, 2, 2, 2, 2, 2, 2, 2, 2]",-100,-8646,"[-1, -10, -10, -10, -10, -10, -10, -10, -10, -10]","[0, 1, 1, 1, 1, 1, 1, 1, 1, 1]",-91,-8817,"[-1, -1, -1, -1, -10, -10, -10, -10, -10, -10]","[0, 2, 1, 5, 1, 1, 1, 1, 1, 1]",-64,-8718
"[-10, -10, -10, -10, -10, -10, -10, -10, -10, -10]","[2, 2, 2, 2, 2, 2, 2, 2, 2, 2]",-100,-8629,"[-10, -10, -10, -10, -10, -10, -10, -10, -10, -10]","[3, 3, 3, 3, 3, 3, 3, 3, 3, 3]",-100,-8809,"[-1, -1, -10, -10, -10, -10, -10, -10, -10, -10]","[0, 2, 1, 1, 1, 1, 1, 1, 1, 1]",-82,-8728,"[-10, -10, -10, -10, -10, -10, -10, -10, -10, -10]","[3, 3, 3, 3, 3, 3, 3, 3, 3, 3]",-100,-8917,"[-1, -1, -10, -10, -10, -10, -10, -10, -10, -10]","[0, 2, 1, 1, 1, 1, 1, 1, 1, 1]",-82,-8800
"[-10, -10, -10, -10, -10, -10, -10, -10, -10, -10]","[3, 3, 3, 3, 3, 3, 3, 3, 3, 3]",-100,-8729,"[-10, -10, -10, -10, -10, -10, -10, -10, -10, -10]","[3, 3, 3, 3, 3, 3, 3, 3, 3, 3]",-100,-8909,"[-10, -10, -10, -10, -10, -10, -10, -10, -10, -10]","[2, 2, 2, 2, 2, 2, 2, 2, 2, 2]",-100,-8828,"[-1, -1, -10, -10, -10, -10, -10, -10, -10, -10]","[0, 2, 1, 1, 1, 1, 1, 1, 1, 1]",-82,-8999,"[-1, -1, -1, -10, -10, -10, -10, -10, -10, -10]","[0, 2, 2, 1, 1, 1, 1, 1, 1, 1]",-73,-8873
"[-1, -1, -10, -10, -10, -10, -10, -10, -10, -10]","[0, 2, 1, 1, 1, 1, 1, 1, 1, 1]",-82,-8811,"[-10, -10, -10, -10, -10, -10, -10, -10, -10, -10]","[2, 2, 2, 2, 2, 2, 2, 2, 2, 2]",-100,-9009,"[-1, -1, -10, -10, -10, -10, -10, -10, -10, -10]","[0, 2, 1, 1, 1, 1, 1, 1, 1, 1]",-82,-8910,"[-1, -1, -1, -1, -10, -10, -10, -10, -10, -10]","[0, 2, 1, 5, 1, 1, 1, 1, 1, 1]",-64,-9063,"[-10, -10, -10, -10, -10, -10, -10, -10, -10, -10]","[3, 3, 3, 3, 3, 3, 3, 3, 3, 3]",-100,-8973
"[-10, -10, -10, -10, -10, -10, -10, -10, -10, -10]","[3, 3, 3, 3, 3, 3, 3, 3, 3, 3]",-100,-8911,"[-10, -10, -10, -10, -10, -10, -10, -10, -10, -10]","[3, 3, 3, 3, 3, 3, 3, 3, 3, 3]",-100,-9109,"[-10, -10, -10, -10, -10, -10, -10, -10, -10, -10]","[3, 3, 3, 3, 3, 3, 3, 3, 3, 3]",-100,-9010,"[-10, -10, -10, -10, -10, -10, -10, -10, -10, -10]","[3, 3, 3, 3, 3, 3, 3, 3, 3, 3]",-100,-9163,"[-1, -1, -10, -10, -10, -10, -10, -10, -10, -10]","[0, 2, 1, 1, 1, 1, 1, 1, 1, 1]",-82,-9055
