0,1,2,3,4,5,6,7,8,9,10,11,12,13,14,15,16,17,18,19
"[-1, -1, -1, -1, 10]","[0, 2, 1, 5, 4]",6,6,"[-10, -10, -10, -10, -10, -10, -10, -10, -10, -10]","[2, 2, 2, 2, 2, 2, 2, 2, 2, 2]",-100,-100,"[-1, -1, 10]","[1, 5, 4]",8,8,"[-10, -10, -10, -10, -10, -10, -10, -10, -10, -10]","[2, 2, 2, 2, 2, 2, 2, 2, 2, 2]",-100,-100,"[-10, -10, -10, -10, -10, -10, -10, -10, -10, -10]","[3, 3, 3, 3, 3, 3, 3, 3, 3, 3]",-100,-100
"[-10, -10, -10, -10, -10, -10, -10, -10, -10, -10]","[3, 3, 3, 3, 3, 3, 3, 3, 3, 3]",-100,-94,"[-1, -1, 10]","[1, 5, 4]",8,-92,"[-1, -1, 10]","[1, 5, 4]",8,16,"[-1, -1, 10]","[0, 3, 4]",8,-92,"[-1, -1, -1, -1, 10]","[0, 2, 1, 5, 4]",6,-94
"[-1, -1, 10]","[1, 5, 4]",8,-86,"[-1, -1, 10]","[1, 5, 4]",8,-84,"[-10, -10, -10, -10, -10, -10, -10, -10, -10, -10]","[3, 3, 3, 3, 3, 3, 3, 3, 3, 3]",-100,-84,"[-10, -10, -10, -10, -10, -10, -10, -10, -10, -10]","[3, 3, 3, 3, 3, 3, 3, 3, 3, 3]",-100,-192,"[-10, -10, -10, -10, -10, -10, -10, -10, -10, -10]","[2, 2, 2, 2, 2, 2, 2, 2, 2, 2]",-100,-194
"[-10, -10, -10, -10, -10, -10, -10, -10, -10, -10]","[3, 3, 3, 3, 3, 3, 3, 3, 3, 3]",-100,-186,"[-1, -1, 10]","[0, 2, 4]",8,-76,"[-10, -10, -10, -10, -10, -10, -10, -10, -10, -10]","[3, 3, 3, 3, 3, 3, 3, 3, 3, 3]",-100,-184,"[-1, -10, -10, -10, -10, -10, -10, -10, -10, -10]","[0, 1, 1, 1, 1, 1, 1, 1, 1, 1]",-91,-283,"[-1, -1, 10]","[0, 2, 4]",8,-186
"[-10, -10, -10, -10, -10, -10, -10, -10, -10, -10]","[3, 3, 3, 3, 3, 3, 3, 3, 3, 3]",-100,-286,"[-10, -10, -10, -10, -10, -10, -10, -10, -10, -10]","[3, 3, 3, 3, 3, 3, 3, 3, 3, 3]",-100,-176,"[-10, -10, -10, -10, -10, -10, -10, -10, -10, -10]","[3, 3, 3, 3, 3, 3, 3, 3, 3, 3]",-100,-284,"[-1, -1, -1, 10]","[0, 4, 2, 4]",7,-276,"[-10, -10, -10, -10, -10, -10, -10, -10, -10, -10]","[2, 2, 2, 2, 2, 2, 2, 2, 2, 2]",-100,-286
"[-10, -10, -10, -10, -10, -10, -10, -10, -10, -10]","[3, 3, 3, 3, 3, 3, 3, 3, 3, 3]",-100,-386,"[-1, -10, -10, -10, -10, -10, -10, -10, -10, -10]","[0, 1, 1, 1, 1, 1, 1, 1, 1, 1]",-91,-267,"[-1, -1, 10]","[1, 5, 4]",8,-276,"[-10, -10, -10, -10, -10, -10, -10, -10, -10, -10]","[3, 3, 3, 3, 3, 3, 3, 3, 3, 3]",-100,-376,"[-1, -1, -1, 10]","[0, 1, 5, 4]",7,-279
"[-1, -1, 10]","[0, 2, 4]",8,-378,"[-1, -1, 10]","[1, 5, 4]",8,-259,"[-1, -1, 10]","[1, 5, 4]",8,-268,"[-10, -10, -10, -10, -10, -10, -10, -10, -10, -10]","[3, 3, 3, 3, 3, 3, 3, 3, 3, 3]",-100,-476,"[-10, -10, -10, -10, -10, -10, -10, -10, -10, -10]","[2, 2, 2, 2, 2, 2, 2, 2, 2, 2]",-100,-379
"[-1, -1, 10]","[0, 2, 4]",8,-370,"[-1, -1, 10]","[1, 5, 4]",8,-251,"[-10, -10, -10, -10, -10, -10, -10, -10, -10, -10]","[3, 3, 3, 3, 3, 3, 3, 3, 3, 3]",-100,-368,"[-1, -1, 10]","[0, 3, 4]",8,-468,"[-10, -10, -10, -10, -10, -10, -10, -10, -10, -10]","[3, 3, 3, 3, 3, 3, 3, 3, 3, 3]",-100,-479
"[-1, -1, 10]","[1, 5, 4]",8,-362,"[-1, -1, 10]","[1, 5, 4]",8,-243,"[-10, -10, -10, -10, -10, -10, -10, -10, -10, -10]","[3, 3, 3, 3, 3, 3, 3, 3, 3, 3]",-100,-468,"[-1, -1, -1, -1, -1, 10]","[0, 2, 2, 1, 5, 4]",5,-463,"[-1, -1, -1, 10]","[0, 4, 2, 4]",7,-472
"[-1, -1, 10]","[1, 5, 4]",8,-354,"[-1, -1, -1, 10]","[0, 4, 2, 4]",7,-236,"[-1, -1, 10]","[1, 5, 4]",8,-460,"[-1, -1, 10]","[0, 2, 4]",8,-455,"[-1, -10, -10, -10, -10, -10, -10, -10, -10, -10]","[0, 1, 1, 1, 1, 1, 1, 1, 1, 1]",-91,-563
"[-10, -10, -10, -10, -10, -10, -10, -10, -10, -10]","[3, 3, 3, 3, 3, 3, 3, 3, 3, 3]",-100,-454,"[-1, -1, 10]","[1, 5, 4]",8,-228,"[-10, -10, -10, -10, -10, -10, -10, -10, -10, -10]","[3, 3, 3, 3, 3, 3, 3, 3, 3, 3]",-100,-560,"[-10, -10, -10, -10, -10, -10, -10, -10, -10, -10]","[3, 3, 3, 3, 3, 3, 3, 3, 3, 3]",-100,-555,"[-1, -1, -1, -1, 10]","[0, 2, 1, 5, 4]",6,-557
"[-10, -10, -10, -10, -10, -10, -10, -10, -10, -10]","[3, 3, 3, 3, 3, 3, 3, 3, 3, 3]",-100,-554,"[-1, -1, 10]","[1, 5, 4]",8,-220,"[-1, -1, -1, -1, 10]","[0, 2, 4, 2, 4]",6,-554,"[-1, -1, -1, 10]","[0, 4, 2, 4]",7,-548,"[-1, -1, -1, 10]","[0, 4, 2, 4]",7,-550
"[-1, -1, 10]","[1, 5, 4]",8,-546,"[-1, -1, -1, -1, 10]","[0, 2, 4, 2, 4]",6,-214,"[-1, -1, 10]","[1, 5, 4]",8,-546,"[-10, -10, -10, -10, -10, -10, -10, -10, -10, -10]","[3, 3, 3, 3, 3, 3, 3, 3, 3, 3]",-100,-648,"[-10, -10, -10, -10, -10, -10, -10, -10, -10, -10]","[3, 3, 3, 3, 3, 3, 3, 3, 3, 3]",-100,-650
"[-10, -10, -10, -10, -10, -10, -10, -10, -10, -10]","[3, 3, 3, 3, 3, 3, 3, 3, 3, 3]",-100,-646,"[-1, -10, -10, -10, -10, -10, -10, -10, -10, -10]","[0, 1, 1, 1, 1, 1, 1, 1, 1, 1]",-91,-305,"[-1, -1, -1, 10]","[0, 1, 5, 4]",7,-539,"[-1, -1, 10]","[1, 5, 4]",8,-640,"[-10, -10, -10, -10, -10, -10, -10, -10, -10, -10]","[3, 3, 3, 3, 3, 3, 3, 3, 3, 3]",-100,-750
"[-1, -1, -1, -1, 10]","[0, 2, 1, 5, 4]",6,-640,"[-1, -1, 10]","[1, 5, 4]",8,-297,"[-1, -1, 10]","[0, 3, 4]",8,-531,"[-10, -10, -10, -10, -10, -10, -10, -10, -10, -10]","[3, 3, 3, 3, 3, 3, 3, 3, 3, 3]",-100,-740,"[-10, -10, -10, -10, -10, -10, -10, -10, -10, -10]","[2, 2, 2, 2, 2, 2, 2, 2, 2, 2]",-100,-850
"[-1, -1, 10]","[0, 2, 4]",8,-632,"[-1, -10, -10, -10, -10, -10, -10, -10, -10, -10]","[0, 1, 1, 1, 1, 1, 1, 1, 1, 1]",-91,-388,"[-10, -10, -10, -10, -10, -10, -10, -10, -10, -10]","[3, 3, 3, 3, 3, 3, 3, 3, 3, 3]",-100,-631,"[-10, -10, -10, -10, -10, -10, -10, -10, -10, -10]","[3, 3, 3, 3, 3, 3, 3, 3, 3, 3]",-100,-840,"[-10, -10, -10, -10, -10, -10, -10, -10, -10, -10]","[2, 2, 2, 2, 2, 2, 2, 2, 2, 2]",-100,-950
"[-1, -1, 10]","[1, 5, 4]",8,-624,"[-1, -1, -1, -1, 10]","[0, 2, 4, 2, 4]",6,-382,"[-1, -1, -1, -1, 10]","[0, 2, 1, 5, 4]",6,-625,"[-1, -1, 10]","[0, 3, 4]",8,-832,"[-1, -1, 10]","[1, 5, 4]",8,-942
"[-1, -1, -1, 10]","[0, 1, 5, 4]",7,-617,"[-10, -10, -10, -10, -10, -10, -10, -10, -10, -10]","[3, 3, 3, 3, 3, 3, 3, 3, 3, 3]",-100,-482,"[-10, -10, -10, -10, -10, -10, -10, -10, -10, -10]","[3, 3, 3, 3, 3, 3, 3, 3, 3, 3]",-100,-725,"[-1, -1, 10]","[1, 5, 4]",8,-824,"[-1, -10, -10, -10, -10, -10, -10, -10, -10, -10]","[0, 1, 1, 1, 1, 1, 1, 1, 1, 1]",-91,-1033
"[-10, -10, -10, -10, -10, -10, -10, -10, -10, -10]","[3, 3, 3, 3, 3, 3, 3, 3, 3, 3]",-100,-717,"[-10, -10, -10, -10, -10, -10, -10, -10, -10, -10]","[3, 3, 3, 3, 3, 3, 3, 3, 3, 3]",-100,-582,"[-1, -1, 10]","[1, 5, 4]",8,-717,"[-1, -10, -10, -10, -10, -10, -10, -10, -10, -10]","[0, 1, 1, 1, 1, 1, 1, 1, 1, 1]",-91,-915,"[-1, -1, 10]","[1, 5, 4]",8,-1025
"[-10, -10, -10, -10, -10, -10, -10, -10, -10, -10]","[3, 3, 3, 3, 3, 3, 3, 3, 3, 3]",-100,-817,"[-10, -10, -10, -10, -10, -10, -10, -10, -10, -10]","[3, 3, 3, 3, 3, 3, 3, 3, 3, 3]",-100,-682,"[-10, -10, -10, -10, -10, -10, -10, -10, -10, -10]","[2, 2, 2, 2, 2, 2, 2, 2, 2, 2]",-100,-817,"[-10, -10, -10, -10, -10, -10, -10, -10, -10, -10]","[2, 2, 2, 2, 2, 2, 2, 2, 2, 2]",-100,-1015,"[-1, -1, -1, -1, 10]","[0, 2, 4, 2, 4]",6,-1019
"[-10, -10, -10, -10, -10, -10, -10, -10, -10, -10]","[3, 3, 3, 3, 3, 3, 3, 3, 3, 3]",-100,-917,"[-1, -1, 10]","[0, 2, 4]",8,-674,"[-10, -10, -10, -10, -10, -10, -10, -10, -10, -10]","[2, 2, 2, 2, 2, 2, 2, 2, 2, 2]",-100,-917,"[-10, -10, -10, -10, -10, -10, -10, -10, -10, -10]","[3, 3, 3, 3, 3, 3, 3, 3, 3, 3]",-100,-1115,"[-1, -1, -1, -1, 10]","[0, 2, 4, 2, 4]",6,-1013
"[-1, -1, 10]","[0, 2, 4]",8,-909,"[-1, -1, 10]","[0, 3, 4]",8,-666,"[-10, -10, -10, -10, -10, -10, -10, -10, -10, -10]","[3, 3, 3, 3, 3, 3, 3, 3, 3, 3]",-100,-1017,"[-10, -10, -10, -10, -10, -10, -10, -10, -10, -10]","[3, 3, 3, 3, 3, 3, 3, 3, 3, 3]",-100,-1215,"[-10, -10, -10, -10, -10, -10, -10, -10, -10, -10]","[2, 2, 2, 2, 2, 2, 2, 2, 2, 2]",-100,-1113
"[-1, -1, 10]","[1, 5, 4]",8,-901,"[-1, -1, -1, 10]","[0, 1, 5, 4]",7,-659,"[-1, -1, -1, -1, -1, 10]","[0, 2, 2, 1, 5, 4]",5,-1012,"[-1, -1, 10]","[1, 5, 4]",8,-1207,"[-1, -1, 10]","[1, 5, 4]",8,-1105
"[-10, -10, -10, -10, -10, -10, -10, -10, -10, -10]","[3, 3, 3, 3, 3, 3, 3, 3, 3, 3]",-100,-1001,"[-10, -10, -10, -10, -10, -10, -10, -10, -10, -10]","[3, 3, 3, 3, 3, 3, 3, 3, 3, 3]",-100,-759,"[-1, -1, -1, -1, 10]","[0, 2, 4, 2, 4]",6,-1006,"[-1, -1, 10]","[0, 3, 4]",8,-1199,"[-10, -10, -10, -10, -10, -10, -10, -10, -10, -10]","[3, 3, 3, 3, 3, 3, 3, 3, 3, 3]",-100,-1205
"[-1, -1, 10]","[1, 5, 4]",8,-993,"[-10, -10, -10, -10, -10, -10, -10, -10, -10, -10]","[2, 2, 2, 2, 2, 2, 2, 2, 2, 2]",-100,-859,"[-1, -1, -1, -1, 10]","[0, 2, 4, 2, 4]",6,-1000,"[-1, -1, 10]","[1, 5, 4]",8,-1191,"[-1, -1, 10]","[0, 3, 4]",8,-1197
"[-1, -1, 10]","[0, 3, 4]",8,-985,"[-1, -1, -1, 10]","[0, 4, 2, 4]",7,-852,"[-10, -10, -10, -10, -10, -10, -10, -10, -10, -10]","[3, 3, 3, 3, 3, 3, 3, 3, 3, 3]",-100,-1100,"[-1, -1, -1, -1, 10]","[0, 2, 1, 5, 4]",6,-1185,"[-10, -10, -10, -10, -10, -10, -10, -10, -10, -10]","[2, 2, 2, 2, 2, 2, 2, 2, 2, 2]",-100,-1297
"[-10, -10, -10, -10, -10, -10, -10, -10, -10, -10]","[3, 3, 3, 3, 3, 3, 3, 3, 3, 3]",-100,-1085,"[-1, -1, -1, -1, 10]","[0, 2, 4, 2, 4]",6,-846,"[-10, -10, -10, -10, -10, -10, -10, -10, -10, -10]","[2, 2, 2, 2, 2, 2, 2, 2, 2, 2]",-100,-1200,"[-1, -1, 10]","[1, 5, 4]",8,-1177,"[-10, -10, -10, -10, -10, -10, -10, -10, -10, -10]","[3, 3, 3, 3, 3, 3, 3, 3, 3, 3]",-100,-1397
"[-1, -1, -1, -1, 10]","[0, 2, 4, 2, 4]",6,-1079,"[-1, -1, 10]","[1, 5, 4]",8,-838,"[-10, -10, -10, -10, -10, -10, -10, -10, -10, -10]","[3, 3, 3, 3, 3, 3, 3, 3, 3, 3]",-100,-1300,"[-1, -1, 10]","[0, 2, 4]",8,-1169,"[-1, -1, 10]","[1, 5, 4]",8,-1389
"[-10, -10, -10, -10, -10, -10, -10, -10, -10, -10]","[3, 3, 3, 3, 3, 3, 3, 3, 3, 3]",-100,-1179,"[-10, -10, -10, -10, -10, -10, -10, -10, -10, -10]","[2, 2, 2, 2, 2, 2, 2, 2, 2, 2]",-100,-938,"[-1, -1, 10]","[0, 3, 4]",8,-1292,"[-1, -1, 10]","[1, 5, 4]",8,-1161,"[-1, -1, 10]","[1, 5, 4]",8,-1381
"[-1, -1, -1, 10]","[0, 4, 2, 4]",7,-1172,"[-1, -1, -1, 10]","[0, 4, 2, 4]",7,-931,"[-1, -1, 10]","[1, 5, 4]",8,-1284,"[-10, -10, -10, -10, -10, -10, -10, -10, -10, -10]","[3, 3, 3, 3, 3, 3, 3, 3, 3, 3]",-100,-1261,"[-1, -1, 10]","[1, 5, 4]",8,-1373
"[-10, -10, -10, -10, -10, -10, -10, -10, -10, -10]","[2, 2, 2, 2, 2, 2, 2, 2, 2, 2]",-100,-1272,"[-10, -10, -10, -10, -10, -10, -10, -10, -10, -10]","[3, 3, 3, 3, 3, 3, 3, 3, 3, 3]",-100,-1031,"[-1, -1, 10]","[0, 2, 4]",8,-1276,"[-1, -1, 10]","[1, 5, 4]",8,-1253,"[-10, -10, -10, -10, -10, -10, -10, -10, -10, -10]","[2, 2, 2, 2, 2, 2, 2, 2, 2, 2]",-100,-1473
"[-1, -1, 10]","[1, 5, 4]",8,-1264,"[-1, -1, 10]","[0, 3, 4]",8,-1023,"[-1, -1, 10]","[1, 5, 4]",8,-1268,"[-1, -1, 10]","[0, 3, 4]",8,-1245,"[-10, -10, -10, -10, -10, -10, -10, -10, -10, -10]","[2, 2, 2, 2, 2, 2, 2, 2, 2, 2]",-100,-1573
"[-10, -10, -10, -10, -10, -10, -10, -10, -10, -10]","[3, 3, 3, 3, 3, 3, 3, 3, 3, 3]",-100,-1364,"[-1, -1, -1, -1, -1, 10]","[0, 2, 2, 1, 5, 4]",5,-1018,"[-10, -10, -10, -10, -10, -10, -10, -10, -10, -10]","[2, 2, 2, 2, 2, 2, 2, 2, 2, 2]",-100,-1368,"[-1, -1, -1, -1, 10]","[0, 2, 4, 2, 4]",6,-1239,"[-1, -1, 10]","[1, 5, 4]",8,-1565
"[-10, -10, -10, -10, -10, -10, -10, -10, -10, -10]","[2, 2, 2, 2, 2, 2, 2, 2, 2, 2]",-100,-1464,"[-1, -1, 10]","[1, 5, 4]",8,-1010,"[-1, -1, -1, 10]","[0, 4, 2, 4]",7,-1361,"[-10, -10, -10, -10, -10, -10, -10, -10, -10, -10]","[3, 3, 3, 3, 3, 3, 3, 3, 3, 3]",-100,-1339,"[-10, -10, -10, -10, -10, -10, -10, -10, -10, -10]","[3, 3, 3, 3, 3, 3, 3, 3, 3, 3]",-100,-1665
"[-10, -10, -10, -10, -10, -10, -10, -10, -10, -10]","[3, 3, 3, 3, 3, 3, 3, 3, 3, 3]",-100,-1564,"[-1, -1, 10]","[0, 2, 4]",8,-1002,"[-1, -1, 10]","[0, 2, 4]",8,-1353,"[-1, -1, 10]","[1, 5, 4]",8,-1331,"[-10, -10, -10, -10, -10, -10, -10, -10, -10, -10]","[3, 3, 3, 3, 3, 3, 3, 3, 3, 3]",-100,-1765
"[-10, -10, -10, -10, -10, -10, -10, -10, -10, -10]","[3, 3, 3, 3, 3, 3, 3, 3, 3, 3]",-100,-1664,"[-1, -1, 10]","[0, 2, 4]",8,-994,"[-1, -1, 10]","[1, 5, 4]",8,-1345,"[-1, -1, 10]","[0, 3, 4]",8,-1323,"[-1, -1, -1, -1, 10]","[0, 2, 4, 2, 4]",6,-1759
"[-1, -1, 10]","[1, 5, 4]",8,-1656,"[-1, -1, 10]","[1, 5, 4]",8,-986,"[-10, -10, -10, -10, -10, -10, -10, -10, -10, -10]","[3, 3, 3, 3, 3, 3, 3, 3, 3, 3]",-100,-1445,"[-1, -1, 10]","[0, 2, 4]",8,-1315,"[-10, -10, -10, -10, -10, -10, -10, -10, -10, -10]","[2, 2, 2, 2, 2, 2, 2, 2, 2, 2]",-100,-1859
"[-10, -10, -10, -10, -10, -10, -10, -10, -10, -10]","[2, 2, 2, 2, 2, 2, 2, 2, 2, 2]",-100,-1756,"[-1, -1, 10]","[1, 5, 4]",8,-978,"[-10, -10, -10, -10, -10, -10, -10, -10, -10, -10]","[3, 3, 3, 3, 3, 3, 3, 3, 3, 3]",-100,-1545,"[-1, -1, 10]","[0, 3, 4]",8,-1307,"[-1, -1, 10]","[0, 2, 4]",8,-1851
"[-1, -1, -1, 10]","[0, 1, 5, 4]",7,-1749,"[-1, -1, -1, 10]","[0, 4, 2, 4]",7,-971,"[-10, -10, -10, -10, -10, -10, -10, -10, -10, -10]","[3, 3, 3, 3, 3, 3, 3, 3, 3, 3]",-100,-1645,"[-10, -10, -10, -10, -10, -10, -10, -10, -10, -10]","[2, 2, 2, 2, 2, 2, 2, 2, 2, 2]",-100,-1407,"[-1, -1, -1, -1, 10]","[0, 2, 4, 2, 4]",6,-1845
"[-1, -1, 10]","[1, 5, 4]",8,-1741,"[-10, -10, -10, -10, -10, -10, -10, -10, -10, -10]","[2, 2, 2, 2, 2, 2, 2, 2, 2, 2]",-100,-1071,"[-10, -10, -10, -10, -10, -10, -10, -10, -10, -10]","[3, 3, 3, 3, 3, 3, 3, 3, 3, 3]",-100,-1745,"[-1, -1, -1, -1, 10]","[0, 2, 1, 5, 4]",6,-1401,"[-1, -1, -1, 10]","[0, 4, 2, 4]",7,-1838
"[-10, -10, -10, -10, -10, -10, -10, -10, -10, -10]","[3, 3, 3, 3, 3, 3, 3, 3, 3, 3]",-100,-1841,"[-10, -10, -10, -10, -10, -10, -10, -10, -10, -10]","[3, 3, 3, 3, 3, 3, 3, 3, 3, 3]",-100,-1171,"[-10, -10, -10, -10, -10, -10, -10, -10, -10, -10]","[3, 3, 3, 3, 3, 3, 3, 3, 3, 3]",-100,-1845,"[-10, -10, -10, -10, -10, -10, -10, -10, -10, -10]","[3, 3, 3, 3, 3, 3, 3, 3, 3, 3]",-100,-1501,"[-10, -10, -10, -10, -10, -10, -10, -10, -10, -10]","[2, 2, 2, 2, 2, 2, 2, 2, 2, 2]",-100,-1938
"[-1, -1, -1, 10]","[0, 1, 5, 4]",7,-1834,"[-10, -10, -10, -10, -10, -10, -10, -10, -10, -10]","[2, 2, 2, 2, 2, 2, 2, 2, 2, 2]",-100,-1271,"[-1, -1, 10]","[0, 2, 4]",8,-1837,"[-1, -1, 10]","[1, 5, 4]",8,-1493,"[-1, -1, -1, 10]","[0, 4, 2, 4]",7,-1931
"[-1, -1, -1, -1, 10]","[0, 2, 1, 5, 4]",6,-1828,"[-10, -10, -10, -10, -10, -10, -10, -10, -10, -10]","[2, 2, 2, 2, 2, 2, 2, 2, 2, 2]",-100,-1371,"[-1, -1, -1, -1, 10]","[0, 2, 4, 2, 4]",6,-1831,"[-1, -1, -1, 10]","[0, 4, 2, 4]",7,-1486,"[-10, -10, -10, -10, -10, -10, -10, -10, -10, -10]","[3, 3, 3, 3, 3, 3, 3, 3, 3, 3]",-100,-2031
"[-1, -1, 10]","[1, 5, 4]",8,-1820,"[-1, -1, 10]","[1, 5, 4]",8,-1363,"[-10, -10, -10, -10, -10, -10, -10, -10, -10, -10]","[2, 2, 2, 2, 2, 2, 2, 2, 2, 2]",-100,-1931,"[-1, -1, -1, 10]","[0, 4, 2, 4]",7,-1479,"[-1, -1, 10]","[1, 5, 4]",8,-2023
"[-1, -1, 10]","[1, 5, 4]",8,-1812,"[-1, -1, 10]","[0, 2, 4]",8,-1355,"[-1, -1, 10]","[1, 5, 4]",8,-1923,"[-1, -1, 10]","[1, 5, 4]",8,-1471,"[-1, -1, -1, -1, 10]","[0, 2, 1, 5, 4]",6,-2017
"[-1, -1, 10]","[0, 2, 4]",8,-1804,"[-10, -10, -10, -10, -10, -10, -10, -10, -10, -10]","[3, 3, 3, 3, 3, 3, 3, 3, 3, 3]",-100,-1455,"[-1, -1, 10]","[0, 2, 4]",8,-1915,"[-1, -1, -1, -1, 10]","[0, 2, 1, 5, 4]",6,-1465,"[-1, -1, 10]","[1, 5, 4]",8,-2009
"[-1, -1, -1, 10]","[0, 4, 2, 4]",7,-1797,"[-10, -10, -10, -10, -10, -10, -10, -10, -10, -10]","[3, 3, 3, 3, 3, 3, 3, 3, 3, 3]",-100,-1555,"[-1, -1, -1, -1, 10]","[0, 2, 4, 2, 4]",6,-1909,"[-1, -1, 10]","[1, 5, 4]",8,-1457,"[-10, -10, -10, -10, -10, -10, -10, -10, -10, -10]","[3, 3, 3, 3, 3, 3, 3, 3, 3, 3]",-100,-2109
"[-1, -1, 10]","[1, 5, 4]",8,-1789,"[-1, -1, 10]","[1, 5, 4]",8,-1547,"[-1, -1, -1, -1, 10]","[0, 2, 1, 5, 4]",6,-1903,"[-1, -1, 10]","[1, 5, 4]",8,-1449,"[-1, -1, 10]","[0, 2, 4]",8,-2101
"[-1, -1, 10]","[0, 2, 4]",8,-1781,"[-1, -1, 10]","[1, 5, 4]",8,-1539,"[-1, -1, -1, -1, -1, 10]","[0, 2, 2, 1, 5, 4]",5,-1898,"[-1, -1, 10]","[1, 5, 4]",8,-1441,"[-1, -1, 10]","[0, 3, 4]",8,-2093
"[-1, -1, -1, 10]","[0, 4, 2, 4]",7,-1774,"[-10, -10, -10, -10, -10, -10, -10, -10, -10, -10]","[3, 3, 3, 3, 3, 3, 3, 3, 3, 3]",-100,-1639,"[-10, -10, -10, -10, -10, -10, -10, -10, -10, -10]","[3, 3, 3, 3, 3, 3, 3, 3, 3, 3]",-100,-1998,"[-10, -10, -10, -10, -10, -10, -10, -10, -10, -10]","[3, 3, 3, 3, 3, 3, 3, 3, 3, 3]",-100,-1541,"[-10, -10, -10, -10, -10, -10, -10, -10, -10, -10]","[3, 3, 3, 3, 3, 3, 3, 3, 3, 3]",-100,-2193
"[-1, -10, -10, -10, -10, -10, -10, -10, -10, -10]","[0, 1, 1, 1, 1, 1, 1, 1, 1, 1]",-91,-1865,"[-1, -1, 10]","[0, 3, 4]",8,-1631,"[-1, -10, -10, -10, -10, -10, -10, -10, -10, -10]","[0, 1, 1, 1, 1, 1, 1, 1, 1, 1]",-91,-2089,"[-1, -10, -10, -10, -10, -10, -10, -10, -10, -10]","[0, 1, 1, 1, 1, 1, 1, 1, 1, 1]",-91,-1632,"[-10, -10, -10, -10, -10, -10, -10, -10, -10, -10]","[3, 3, 3, 3, 3, 3, 3, 3, 3, 3]",-100,-2293
"[-10, -10, -10, -10, -10, -10, -10, -10, -10, -10]","[2, 2, 2, 2, 2, 2, 2, 2, 2, 2]",-100,-1965,"[-1, -1, 10]","[0, 2, 4]",8,-1623,"[-1, -1, 10]","[0, 3, 4]",8,-2081,"[-10, -10, -10, -10, -10, -10, -10, -10, -10, -10]","[3, 3, 3, 3, 3, 3, 3, 3, 3, 3]",-100,-1732,"[-1, -1, -1, 10]","[0, 4, 2, 4]",7,-2286
"[-10, -10, -10, -10, -10, -10, -10, -10, -10, -10]","[3, 3, 3, 3, 3, 3, 3, 3, 3, 3]",-100,-2065,"[-1, -1, 10]","[1, 5, 4]",8,-1615,"[-10, -10, -10, -10, -10, -10, -10, -10, -10, -10]","[3, 3, 3, 3, 3, 3, 3, 3, 3, 3]",-100,-2181,"[-1, -1, -1, -1, -1, 10]","[0, 2, 2, 1, 5, 4]",5,-1727,"[-10, -10, -10, -10, -10, -10, -10, -10, -10, -10]","[2, 2, 2, 2, 2, 2, 2, 2, 2, 2]",-100,-2386
"[-10, -10, -10, -10, -10, -10, -10, -10, -10, -10]","[3, 3, 3, 3, 3, 3, 3, 3, 3, 3]",-100,-2165,"[-10, -10, -10, -10, -10, -10, -10, -10, -10, -10]","[2, 2, 2, 2, 2, 2, 2, 2, 2, 2]",-100,-1715,"[-10, -10, -10, -10, -10, -10, -10, -10, -10, -10]","[3, 3, 3, 3, 3, 3, 3, 3, 3, 3]",-100,-2281,"[-10, -10, -10, -10, -10, -10, -10, -10, -10, -10]","[3, 3, 3, 3, 3, 3, 3, 3, 3, 3]",-100,-1827,"[-1, -1, 10]","[0, 2, 4]",8,-2378
"[-1, -1, 10]","[1, 5, 4]",8,-2157,"[-1, -1, 10]","[1, 5, 4]",8,-1707,"[-1, -1, 10]","[1, 5, 4]",8,-2273,"[-1, -1, 10]","[0, 2, 4]",8,-1819,"[-10, -10, -10, -10, -10, -10, -10, -10, -10, -10]","[2, 2, 2, 2, 2, 2, 2, 2, 2, 2]",-100,-2478
"[-1, -1, 10]","[1, 5, 4]",8,-2149,"[-1, -1, 10]","[0, 2, 4]",8,-1699,"[-1, -1, -1, -1, 10]","[0, 2, 1, 5, 4]",6,-2267,"[-1, -1, 10]","[1, 5, 4]",8,-1811,"[-10, -10, -10, -10, -10, -10, -10, -10, -10, -10]","[3, 3, 3, 3, 3, 3, 3, 3, 3, 3]",-100,-2578
"[-10, -10, -10, -10, -10, -10, -10, -10, -10, -10]","[2, 2, 2, 2, 2, 2, 2, 2, 2, 2]",-100,-2249,"[-1, -1, -1, 10]","[0, 4, 2, 4]",7,-1692,"[-1, -1, 10]","[1, 5, 4]",8,-2259,"[-10, -10, -10, -10, -10, -10, -10, -10, -10, -10]","[3, 3, 3, 3, 3, 3, 3, 3, 3, 3]",-100,-1911,"[-1, -1, 10]","[0, 3, 4]",8,-2570
"[-1, -1, 10]","[0, 3, 4]",8,-2241,"[-1, -1, -1, 10]","[0, 4, 2, 4]",7,-1685,"[-10, -10, -10, -10, -10, -10, -10, -10, -10, -10]","[3, 3, 3, 3, 3, 3, 3, 3, 3, 3]",-100,-2359,"[-1, -10, -10, -10, -10, -10, -10, -10, -10, -10]","[0, 1, 1, 1, 1, 1, 1, 1, 1, 1]",-91,-2002,"[-10, -10, -10, -10, -10, -10, -10, -10, -10, -10]","[3, 3, 3, 3, 3, 3, 3, 3, 3, 3]",-100,-2670
"[-1, -1, 10]","[1, 5, 4]",8,-2233,"[-1, -1, -1, 10]","[0, 4, 2, 4]",7,-1678,"[-1, -10, -10, -10, -10, -10, -10, -10, -10, -10]","[0, 1, 1, 1, 1, 1, 1, 1, 1, 1]",-91,-2450,"[-10, -10, -10, -10, -10, -10, -10, -10, -10, -10]","[2, 2, 2, 2, 2, 2, 2, 2, 2, 2]",-100,-2102,"[-10, -10, -10, -10, -10, -10, -10, -10, -10, -10]","[3, 3, 3, 3, 3, 3, 3, 3, 3, 3]",-100,-2770
"[-1, -1, 10]","[0, 3, 4]",8,-2225,"[-1, -1, 10]","[1, 5, 4]",8,-1670,"[-1, -10, -10, -10, -10, -10, -10, -10, -10, -10]","[0, 1, 1, 1, 1, 1, 1, 1, 1, 1]",-91,-2541,"[-1, -1, 10]","[1, 5, 4]",8,-2094,"[-1, -1, 10]","[1, 5, 4]",8,-2762
"[-1, -1, 10]","[1, 5, 4]",8,-2217,"[-1, -1, 10]","[1, 5, 4]",8,-1662,"[-10, -10, -10, -10, -10, -10, -10, -10, -10, -10]","[3, 3, 3, 3, 3, 3, 3, 3, 3, 3]",-100,-2641,"[-10, -10, -10, -10, -10, -10, -10, -10, -10, -10]","[2, 2, 2, 2, 2, 2, 2, 2, 2, 2]",-100,-2194,"[-10, -10, -10, -10, -10, -10, -10, -10, -10, -10]","[3, 3, 3, 3, 3, 3, 3, 3, 3, 3]",-100,-2862
"[-1, -10, -10, -10, -10, -10, -10, -10, -10, -10]","[0, 1, 1, 1, 1, 1, 1, 1, 1, 1]",-91,-2308,"[-10, -10, -10, -10, -10, -10, -10, -10, -10, -10]","[2, 2, 2, 2, 2, 2, 2, 2, 2, 2]",-100,-1762,"[-10, -10, -10, -10, -10, -10, -10, -10, -10, -10]","[3, 3, 3, 3, 3, 3, 3, 3, 3, 3]",-100,-2741,"[-1, -1, -1, -1, 10]","[0, 2, 1, 5, 4]",6,-2188,"[-10, -10, -10, -10, -10, -10, -10, -10, -10, -10]","[2, 2, 2, 2, 2, 2, 2, 2, 2, 2]",-100,-2962
"[-10, -10, -10, -10, -10, -10, -10, -10, -10, -10]","[3, 3, 3, 3, 3, 3, 3, 3, 3, 3]",-100,-2408,"[-10, -10, -10, -10, -10, -10, -10, -10, -10, -10]","[2, 2, 2, 2, 2, 2, 2, 2, 2, 2]",-100,-1862,"[-1, -1, -1, -1, 10]","[0, 2, 4, 2, 4]",6,-2735,"[-10, -10, -10, -10, -10, -10, -10, -10, -10, -10]","[3, 3, 3, 3, 3, 3, 3, 3, 3, 3]",-100,-2288,"[-10, -10, -10, -10, -10, -10, -10, -10, -10, -10]","[3, 3, 3, 3, 3, 3, 3, 3, 3, 3]",-100,-3062
"[-1, -1, -1, -1, 10]","[0, 2, 1, 5, 4]",6,-2402,"[-1, -1, 10]","[1, 5, 4]",8,-1854,"[-1, -1, 10]","[0, 2, 4]",8,-2727,"[-1, -10, -10, -10, -10, -10, -10, -10, -10, -10]","[0, 1, 1, 1, 1, 1, 1, 1, 1, 1]",-91,-2379,"[-1, -1, 10]","[1, 5, 4]",8,-3054
"[-1, -1, 10]","[0, 3, 4]",8,-2394,"[-10, -10, -10, -10, -10, -10, -10, -10, -10, -10]","[3, 3, 3, 3, 3, 3, 3, 3, 3, 3]",-100,-1954,"[-10, -10, -10, -10, -10, -10, -10, -10, -10, -10]","[3, 3, 3, 3, 3, 3, 3, 3, 3, 3]",-100,-2827,"[-1, -1, 10]","[0, 3, 4]",8,-2371,"[-1, -1, 10]","[1, 5, 4]",8,-3046
"[-1, -1, 10]","[0, 3, 4]",8,-2386,"[-10, -10, -10, -10, -10, -10, -10, -10, -10, -10]","[2, 2, 2, 2, 2, 2, 2, 2, 2, 2]",-100,-2054,"[-1, -1, 10]","[1, 5, 4]",8,-2819,"[-10, -10, -10, -10, -10, -10, -10, -10, -10, -10]","[2, 2, 2, 2, 2, 2, 2, 2, 2, 2]",-100,-2471,"[-1, -1, 10]","[1, 5, 4]",8,-3038
"[-10, -10, -10, -10, -10, -10, -10, -10, -10, -10]","[2, 2, 2, 2, 2, 2, 2, 2, 2, 2]",-100,-2486,"[-10, -10, -10, -10, -10, -10, -10, -10, -10, -10]","[3, 3, 3, 3, 3, 3, 3, 3, 3, 3]",-100,-2154,"[-1, -1, 10]","[1, 5, 4]",8,-2811,"[-1, -1, 10]","[0, 3, 4]",8,-2463,"[-1, -1, -1, 10]","[0, 1, 5, 4]",7,-3031
"[-1, -1, 10]","[0, 3, 4]",8,-2478,"[-1, -1, 10]","[1, 5, 4]",8,-2146,"[-1, -1, -1, -1, 10]","[0, 2, 4, 2, 4]",6,-2805,"[-10, -10, -10, -10, -10, -10, -10, -10, -10, -10]","[3, 3, 3, 3, 3, 3, 3, 3, 3, 3]",-100,-2563,"[-1, -1, -1, -1, 10]","[0, 2, 1, 5, 4]",6,-3025
"[-1, -1, 10]","[1, 5, 4]",8,-2470,"[-10, -10, -10, -10, -10, -10, -10, -10, -10, -10]","[2, 2, 2, 2, 2, 2, 2, 2, 2, 2]",-100,-2246,"[-10, -10, -10, -10, -10, -10, -10, -10, -10, -10]","[2, 2, 2, 2, 2, 2, 2, 2, 2, 2]",-100,-2905,"[-1, -1, 10]","[0, 2, 4]",8,-2555,"[-1, -1, 10]","[0, 2, 4]",8,-3017
"[-10, -10, -10, -10, -10, -10, -10, -10, -10, -10]","[3, 3, 3, 3, 3, 3, 3, 3, 3, 3]",-100,-2570,"[-1, -1, 10]","[1, 5, 4]",8,-2238,"[-1, -1, 10]","[1, 5, 4]",8,-2897,"[-1, -1, 10]","[1, 5, 4]",8,-2547,"[-10, -10, -10, -10, -10, -10, -10, -10, -10, -10]","[3, 3, 3, 3, 3, 3, 3, 3, 3, 3]",-100,-3117
"[-10, -10, -10, -10, -10, -10, -10, -10, -10, -10]","[3, 3, 3, 3, 3, 3, 3, 3, 3, 3]",-100,-2670,"[-1, -1, 10]","[1, 5, 4]",8,-2230,"[-1, -1, 10]","[0, 3, 4]",8,-2889,"[-10, -10, -10, -10, -10, -10, -10, -10, -10, -10]","[3, 3, 3, 3, 3, 3, 3, 3, 3, 3]",-100,-2647,"[-10, -10, -10, -10, -10, -10, -10, -10, -10, -10]","[3, 3, 3, 3, 3, 3, 3, 3, 3, 3]",-100,-3217
"[-1, -10, -10, -10, -10, -10, -10, -10, -10, -10]","[1, 5, 5, 5, 5, 5, 5, 5, 5, 5]",-91,-2761,"[-10, -10, -10, -10, -10, -10, -10, -10, -10, -10]","[2, 2, 2, 2, 2, 2, 2, 2, 2, 2]",-100,-2330,"[-10, -10, -10, -10, -10, -10, -10, -10, -10, -10]","[3, 3, 3, 3, 3, 3, 3, 3, 3, 3]",-100,-2989,"[-1, -1, 10]","[1, 5, 4]",8,-2639,"[-1, -10, -10, -10, -10, -10, -10, -10, -10, -10]","[1, 5, 5, 5, 5, 5, 5, 5, 5, 5]",-91,-3308
"[-1, -1, 10]","[0, 3, 4]",8,-2753,"[-10, -10, -10, -10, -10, -10, -10, -10, -10, -10]","[3, 3, 3, 3, 3, 3, 3, 3, 3, 3]",-100,-2430,"[-1, -1, 10]","[1, 5, 4]",8,-2981,"[-1, -1, 10]","[1, 5, 4]",8,-2631,"[-1, -1, -1, -1, 10]","[0, 2, 1, 5, 4]",6,-3302
"[-10, -10, -10, -10, -10, -10, -10, -10, -10, -10]","[3, 3, 3, 3, 3, 3, 3, 3, 3, 3]",-100,-2853,"[-1, -1, 10]","[0, 2, 4]",8,-2422,"[-10, -10, -10, -10, -10, -10, -10, -10, -10, -10]","[3, 3, 3, 3, 3, 3, 3, 3, 3, 3]",-100,-3081,"[-1, -1, 10]","[0, 3, 4]",8,-2623,"[-10, -10, -10, -10, -10, -10, -10, -10, -10, -10]","[3, 3, 3, 3, 3, 3, 3, 3, 3, 3]",-100,-3402
"[-10, -10, -10, -10, -10, -10, -10, -10, -10, -10]","[3, 3, 3, 3, 3, 3, 3, 3, 3, 3]",-100,-2953,"[-1, -1, 10]","[0, 3, 4]",8,-2414,"[-1, -1, 10]","[1, 5, 4]",8,-3073,"[-1, -1, 10]","[0, 2, 4]",8,-2615,"[-10, -10, -10, -10, -10, -10, -10, -10, -10, -10]","[3, 3, 3, 3, 3, 3, 3, 3, 3, 3]",-100,-3502
"[-10, -10, -10, -10, -10, -10, -10, -10, -10, -10]","[2, 2, 2, 2, 2, 2, 2, 2, 2, 2]",-100,-3053,"[-1, -1, -1, 10]","[0, 1, 5, 4]",7,-2407,"[-10, -10, -10, -10, -10, -10, -10, -10, -10, -10]","[3, 3, 3, 3, 3, 3, 3, 3, 3, 3]",-100,-3173,"[-1, -1, -1, -1, 10]","[0, 2, 1, 5, 4]",6,-2609,"[-1, -1, 10]","[1, 5, 4]",8,-3494
"[-1, -1, 10]","[1, 5, 4]",8,-3045,"[-10, -10, -10, -10, -10, -10, -10, -10, -10, -10]","[3, 3, 3, 3, 3, 3, 3, 3, 3, 3]",-100,-2507,"[-1, -1, 10]","[1, 5, 4]",8,-3165,"[-10, -10, -10, -10, -10, -10, -10, -10, -10, -10]","[3, 3, 3, 3, 3, 3, 3, 3, 3, 3]",-100,-2709,"[-1, -10, -10, -10, -10, -10, -10, -10, -10, -10]","[0, 1, 1, 1, 1, 1, 1, 1, 1, 1]",-91,-3585
"[-1, -1, -1, -1, -1, 10]","[0, 2, 2, 1, 5, 4]",5,-3040,"[-10, -10, -10, -10, -10, -10, -10, -10, -10, -10]","[3, 3, 3, 3, 3, 3, 3, 3, 3, 3]",-100,-2607,"[-10, -10, -10, -10, -10, -10, -10, -10, -10, -10]","[2, 2, 2, 2, 2, 2, 2, 2, 2, 2]",-100,-3265,"[-10, -10, -10, -10, -10, -10, -10, -10, -10, -10]","[3, 3, 3, 3, 3, 3, 3, 3, 3, 3]",-100,-2809,"[-10, -10, -10, -10, -10, -10, -10, -10, -10, -10]","[3, 3, 3, 3, 3, 3, 3, 3, 3, 3]",-100,-3685
"[-10, -10, -10, -10, -10, -10, -10, -10, -10, -10]","[3, 3, 3, 3, 3, 3, 3, 3, 3, 3]",-100,-3140,"[-1, -10, -10, -10, -10, -10, -10, -10, -10, -10]","[0, 1, 1, 1, 1, 1, 1, 1, 1, 1]",-91,-2698,"[-1, -1, -1, 10]","[0, 4, 2, 4]",7,-3258,"[-1, -1, -1, 10]","[0, 4, 2, 4]",7,-2802,"[-1, -1, 10]","[0, 2, 4]",8,-3677
"[-1, -1, 10]","[0, 3, 4]",8,-3132,"[-10, -10, -10, -10, -10, -10, -10, -10, -10, -10]","[3, 3, 3, 3, 3, 3, 3, 3, 3, 3]",-100,-2798,"[-1, -1, 10]","[1, 5, 4]",8,-3250,"[-1, -1, -1, -1, 10]","[0, 2, 4, 2, 4]",6,-2796,"[-1, -1, -1, -1, 10]","[0, 2, 4, 2, 4]",6,-3671
"[-10, -10, -10, -10, -10, -10, -10, -10, -10, -10]","[3, 3, 3, 3, 3, 3, 3, 3, 3, 3]",-100,-3232,"[-10, -10, -10, -10, -10, -10, -10, -10, -10, -10]","[3, 3, 3, 3, 3, 3, 3, 3, 3, 3]",-100,-2898,"[-1, -1, -1, 10]","[0, 4, 2, 4]",7,-3243,"[-1, -1, 10]","[0, 3, 4]",8,-2788,"[-10, -10, -10, -10, -10, -10, -10, -10, -10, -10]","[3, 3, 3, 3, 3, 3, 3, 3, 3, 3]",-100,-3771
"[-1, -1, 10]","[0, 2, 4]",8,-3224,"[-10, -10, -10, -10, -10, -10, -10, -10, -10, -10]","[3, 3, 3, 3, 3, 3, 3, 3, 3, 3]",-100,-2998,"[-10, -10, -10, -10, -10, -10, -10, -10, -10, -10]","[3, 3, 3, 3, 3, 3, 3, 3, 3, 3]",-100,-3343,"[-10, -10, -10, -10, -10, -10, -10, -10, -10, -10]","[2, 2, 2, 2, 2, 2, 2, 2, 2, 2]",-100,-2888,"[-1, -1, 10]","[0, 2, 4]",8,-3763
"[-1, -1, 10]","[0, 3, 4]",8,-3216,"[-10, -10, -10, -10, -10, -10, -10, -10, -10, -10]","[3, 3, 3, 3, 3, 3, 3, 3, 3, 3]",-100,-3098,"[-1, -1, 10]","[0, 2, 4]",8,-3335,"[-10, -10, -10, -10, -10, -10, -10, -10, -10, -10]","[3, 3, 3, 3, 3, 3, 3, 3, 3, 3]",-100,-2988,"[-10, -10, -10, -10, -10, -10, -10, -10, -10, -10]","[3, 3, 3, 3, 3, 3, 3, 3, 3, 3]",-100,-3863
"[-10, -10, -10, -10, -10, -10, -10, -10, -10, -10]","[3, 3, 3, 3, 3, 3, 3, 3, 3, 3]",-100,-3316,"[-1, -1, 10]","[1, 5, 4]",8,-3090,"[-10, -10, -10, -10, -10, -10, -10, -10, -10, -10]","[3, 3, 3, 3, 3, 3, 3, 3, 3, 3]",-100,-3435,"[-1, -1, 10]","[1, 5, 4]",8,-2980,"[-1, -1, 10]","[0, 2, 4]",8,-3855
"[-1, -10, -10, -10, -10, -10, -10, -10, -10, -10]","[0, 1, 1, 1, 1, 1, 1, 1, 1, 1]",-91,-3407,"[-1, -1, 10]","[0, 2, 4]",8,-3082,"[-1, -1, 10]","[0, 3, 4]",8,-3427,"[-1, -1, -1, -1, 10]","[0, 2, 4, 2, 4]",6,-2974,"[-1, -1, -1, -1, 10]","[0, 2, 1, 5, 4]",6,-3849
"[-10, -10, -10, -10, -10, -10, -10, -10, -10, -10]","[3, 3, 3, 3, 3, 3, 3, 3, 3, 3]",-100,-3507,"[-10, -10, -10, -10, -10, -10, -10, -10, -10, -10]","[2, 2, 2, 2, 2, 2, 2, 2, 2, 2]",-100,-3182,"[-1, -1, 10]","[1, 5, 4]",8,-3419,"[-1, -1, 10]","[0, 3, 4]",8,-2966,"[-10, -10, -10, -10, -10, -10, -10, -10, -10, -10]","[3, 3, 3, 3, 3, 3, 3, 3, 3, 3]",-100,-3949
"[-1, -1, 10]","[0, 3, 4]",8,-3499,"[-10, -10, -10, -10, -10, -10, -10, -10, -10, -10]","[3, 3, 3, 3, 3, 3, 3, 3, 3, 3]",-100,-3282,"[-1, -1, -1, -1, 10]","[0, 2, 4, 2, 4]",6,-3413,"[-1, -1, -1, -1, -1, 10]","[0, 2, 2, 1, 5, 4]",5,-2961,"[-10, -10, -10, -10, -10, -10, -10, -10, -10, -10]","[3, 3, 3, 3, 3, 3, 3, 3, 3, 3]",-100,-4049
"[-1, -1, 10]","[1, 5, 4]",8,-3491,"[-1, -1, -1, -1, 10]","[0, 2, 1, 5, 4]",6,-3276,"[-1, -1, 10]","[1, 5, 4]",8,-3405,"[-1, -1, 10]","[1, 5, 4]",8,-2953,"[-1, -1, -1, -1, 10]","[0, 2, 1, 5, 4]",6,-4043
"[-1, -1, 10]","[0, 2, 4]",8,-3483,"[-1, -10, -10, -10, -10, -10, -10, -10, -10, -10]","[0, 1, 1, 1, 1, 1, 1, 1, 1, 1]",-91,-3367,"[-10, -10, -10, -10, -10, -10, -10, -10, -10, -10]","[2, 2, 2, 2, 2, 2, 2, 2, 2, 2]",-100,-3505,"[-10, -10, -10, -10, -10, -10, -10, -10, -10, -10]","[2, 2, 2, 2, 2, 2, 2, 2, 2, 2]",-100,-3053,"[-1, -1, 10]","[1, 5, 4]",8,-4035
"[-1, -1, -1, 10]","[0, 4, 2, 4]",7,-3476,"[-10, -10, -10, -10, -10, -10, -10, -10, -10, -10]","[3, 3, 3, 3, 3, 3, 3, 3, 3, 3]",-100,-3467,"[-1, -1, 10]","[1, 5, 4]",8,-3497,"[-1, -1, 10]","[1, 5, 4]",8,-3045,"[-1, -1, 10]","[1, 5, 4]",8,-4027
"[-10, -10, -10, -10, -10, -10, -10, -10, -10, -10]","[3, 3, 3, 3, 3, 3, 3, 3, 3, 3]",-100,-3576,"[-10, -10, -10, -10, -10, -10, -10, -10, -10, -10]","[2, 2, 2, 2, 2, 2, 2, 2, 2, 2]",-100,-3567,"[-1, -1, 10]","[1, 5, 4]",8,-3489,"[-10, -10, -10, -10, -10, -10, -10, -10, -10, -10]","[3, 3, 3, 3, 3, 3, 3, 3, 3, 3]",-100,-3145,"[-1, -1, 10]","[1, 5, 4]",8,-4019
"[-1, -1, 10]","[1, 5, 4]",8,-3568,"[-1, -1, 10]","[1, 5, 4]",8,-3559,"[-10, -10, -10, -10, -10, -10, -10, -10, -10, -10]","[2, 2, 2, 2, 2, 2, 2, 2, 2, 2]",-100,-3589,"[-1, -1, -1, 10]","[0, 4, 2, 4]",7,-3138,"[-1, -1, 10]","[1, 5, 4]",8,-4011
"[-10, -10, -10, -10, -10, -10, -10, -10, -10, -10]","[3, 3, 3, 3, 3, 3, 3, 3, 3, 3]",-100,-3668,"[-1, -1, 10]","[1, 5, 4]",8,-3551,"[-1, -1, 10]","[0, 2, 4]",8,-3581,"[-1, -1, 10]","[0, 2, 4]",8,-3130,"[-1, -1, 10]","[0, 3, 4]",8,-4003
"[-10, -10, -10, -10, -10, -10, -10, -10, -10, -10]","[2, 2, 2, 2, 2, 2, 2, 2, 2, 2]",-100,-3768,"[-1, -1, 10]","[0, 3, 4]",8,-3543,"[-10, -10, -10, -10, -10, -10, -10, -10, -10, -10]","[3, 3, 3, 3, 3, 3, 3, 3, 3, 3]",-100,-3681,"[-1, -1, 10]","[0, 2, 4]",8,-3122,"[-10, -10, -10, -10, -10, -10, -10, -10, -10, -10]","[3, 3, 3, 3, 3, 3, 3, 3, 3, 3]",-100,-4103
"[-10, -10, -10, -10, -10, -10, -10, -10, -10, -10]","[3, 3, 3, 3, 3, 3, 3, 3, 3, 3]",-100,-3868,"[-1, -1, 10]","[0, 2, 4]",8,-3535,"[-1, -1, 10]","[1, 5, 4]",8,-3673,"[-10, -10, -10, -10, -10, -10, -10, -10, -10, -10]","[3, 3, 3, 3, 3, 3, 3, 3, 3, 3]",-100,-3222,"[-10, -10, -10, -10, -10, -10, -10, -10, -10, -10]","[2, 2, 2, 2, 2, 2, 2, 2, 2, 2]",-100,-4203
"[-1, -1, 10]","[1, 5, 4]",8,-3860,"[-1, -1, -1, 10]","[0, 4, 2, 4]",7,-3528,"[-10, -10, -10, -10, -10, -10, -10, -10, -10, -10]","[3, 3, 3, 3, 3, 3, 3, 3, 3, 3]",-100,-3773,"[-10, -10, -10, -10, -10, -10, -10, -10, -10, -10]","[3, 3, 3, 3, 3, 3, 3, 3, 3, 3]",-100,-3322,"[-1, -1, 10]","[1, 5, 4]",8,-4195
"[-10, -10, -10, -10, -10, -10, -10, -10, -10, -10]","[3, 3, 3, 3, 3, 3, 3, 3, 3, 3]",-100,-3960,"[-1, -1, -1, 10]","[0, 1, 5, 4]",7,-3521,"[-10, -10, -10, -10, -10, -10, -10, -10, -10, -10]","[2, 2, 2, 2, 2, 2, 2, 2, 2, 2]",-100,-3873,"[-10, -10, -10, -10, -10, -10, -10, -10, -10, -10]","[2, 2, 2, 2, 2, 2, 2, 2, 2, 2]",-100,-3422,"[-1, -1, -1, -1, 10]","[0, 2, 4, 2, 4]",6,-4189
"[-1, -10, -10, -10, -10, -10, -10, -10, -10, -10]","[0, 1, 1, 1, 1, 1, 1, 1, 1, 1]",-91,-4051,"[-10, -10, -10, -10, -10, -10, -10, -10, -10, -10]","[3, 3, 3, 3, 3, 3, 3, 3, 3, 3]",-100,-3621,"[-1, -1, 10]","[1, 5, 4]",8,-3865,"[-1, -1, 10]","[1, 5, 4]",8,-3414,"[-1, -1, 10]","[1, 5, 4]",8,-4181
"[-1, -1, -1, -1, 10]","[0, 2, 4, 2, 4]",6,-4045,"[-1, -1, 10]","[1, 5, 4]",8,-3613,"[-1, -1, -1, -1, 10]","[0, 2, 4, 2, 4]",6,-3859,"[-1, -1, 10]","[0, 3, 4]",8,-3406,"[-1, -1, -1, 10]","[0, 1, 5, 4]",7,-4174
"[-1, -1, 10]","[0, 3, 4]",8,-4037,"[-1, -10, -10, -10, -10, -10, -10, -10, -10, -10]","[0, 1, 1, 1, 1, 1, 1, 1, 1, 1]",-91,-3704,"[-1, -1, 10]","[0, 3, 4]",8,-3851,"[-1, -1, 10]","[0, 3, 4]",8,-3398,"[-1, -1, 10]","[1, 5, 4]",8,-4166
