0,1,2,3,4,5,6,7,8,9,10,11,12,13,14,15,16,17,18,19
"[-10, -10, -10, -10, -10, -10, -10, -10, -10, -10]","[2, 2, 2, 2, 2, 2, 2, 2, 2, 2]",-100,-100,"[-1, -1, -1, 10]","[0, 4, 2, 4]",7,7,"[-1, -1, -1, -1, 10]","[0, 2, 1, 5, 4]",6,6,"[-1, -1, 10]","[0, 2, 4]",8,8,"[-1, -1, 10]","[0, 2, 4]",8,8
"[-10, -10, -10, -10, -10, -10, -10, -10, -10, -10]","[2, 2, 2, 2, 2, 2, 2, 2, 2, 2]",-100,-200,"[-1, -1, 10]","[1, 5, 4]",8,15,"[-1, -1, 10]","[1, 5, 4]",8,14,"[-10, -10, -10, -10, -10, -10, -10, -10, -10, -10]","[2, 2, 2, 2, 2, 2, 2, 2, 2, 2]",-100,-92,"[-10, -10, -10, -10, -10, -10, -10, -10, -10, -10]","[2, 2, 2, 2, 2, 2, 2, 2, 2, 2]",-100,-92
"[-1, -1, 10]","[1, 5, 4]",8,-192,"[-1, -1, 10]","[1, 5, 4]",8,23,"[-10, -10, -10, -10, -10, -10, -10, -10, -10, -10]","[2, 2, 2, 2, 2, 2, 2, 2, 2, 2]",-100,-86,"[-10, -10, -10, -10, -10, -10, -10, -10, -10, -10]","[3, 3, 3, 3, 3, 3, 3, 3, 3, 3]",-100,-192,"[-1, -1, 10]","[1, 5, 4]",8,-84
"[-1, -1, 10]","[0, 2, 4]",8,-184,"[-10, -10, -10, -10, -10, -10, -10, -10, -10, -10]","[3, 3, 3, 3, 3, 3, 3, 3, 3, 3]",-100,-77,"[-1, -1, 10]","[0, 3, 4]",8,-78,"[-10, -10, -10, -10, -10, -10, -10, -10, -10, -10]","[2, 2, 2, 2, 2, 2, 2, 2, 2, 2]",-100,-292,"[-1, -1, 10]","[0, 2, 4]",8,-76
"[-1, -1, 10]","[1, 5, 4]",8,-176,"[-1, -1, 10]","[1, 5, 4]",8,-69,"[-1, -1, 10]","[0, 2, 4]",8,-70,"[-1, -1, 10]","[0, 2, 4]",8,-284,"[-1, -1, 10]","[1, 5, 4]",8,-68
"[-1, -1, 10]","[1, 5, 4]",8,-168,"[-10, -10, -10, -10, -10, -10, -10, -10, -10, -10]","[2, 2, 2, 2, 2, 2, 2, 2, 2, 2]",-100,-169,"[-10, -10, -10, -10, -10, -10, -10, -10, -10, -10]","[3, 3, 3, 3, 3, 3, 3, 3, 3, 3]",-100,-170,"[-1, -1, 10]","[0, 2, 4]",8,-276,"[-1, -1, 10]","[1, 5, 4]",8,-60
"[-10, -10, -10, -10, -10, -10, -10, -10, -10, -10]","[3, 3, 3, 3, 3, 3, 3, 3, 3, 3]",-100,-268,"[-10, -10, -10, -10, -10, -10, -10, -10, -10, -10]","[2, 2, 2, 2, 2, 2, 2, 2, 2, 2]",-100,-269,"[-1, -1, -1, -1, 10]","[0, 2, 1, 5, 4]",6,-164,"[-1, -1, 10]","[0, 3, 4]",8,-268,"[-10, -10, -10, -10, -10, -10, -10, -10, -10, -10]","[3, 3, 3, 3, 3, 3, 3, 3, 3, 3]",-100,-160
"[-1, -1, 10]","[1, 5, 4]",8,-260,"[-10, -10, -10, -10, -10, -10, -10, -10, -10, -10]","[2, 2, 2, 2, 2, 2, 2, 2, 2, 2]",-100,-369,"[-1, -1, 10]","[0, 3, 4]",8,-156,"[-10, -10, -10, -10, -10, -10, -10, -10, -10, -10]","[2, 2, 2, 2, 2, 2, 2, 2, 2, 2]",-100,-368,"[-1, -1, 10]","[1, 5, 4]",8,-152
"[-10, -10, -10, -10, -10, -10, -10, -10, -10, -10]","[2, 2, 2, 2, 2, 2, 2, 2, 2, 2]",-100,-360,"[-1, -1, -1, 10]","[0, 2, 2, 4]",7,-362,"[-1, -1, 10]","[0, 2, 4]",8,-148,"[-1, -1, 10]","[1, 5, 4]",8,-360,"[-1, -1, 10]","[1, 5, 4]",8,-144
"[-10, -10, -10, -10, -10, -10, -10, -10, -10, -10]","[2, 2, 2, 2, 2, 2, 2, 2, 2, 2]",-100,-460,"[-1, -1, 10]","[1, 5, 4]",8,-354,"[-10, -10, -10, -10, -10, -10, -10, -10, -10, -10]","[2, 2, 2, 2, 2, 2, 2, 2, 2, 2]",-100,-248,"[-1, -1, 10]","[1, 5, 4]",8,-352,"[-1, -1, 10]","[0, 2, 4]",8,-136
"[-1, -1, 10]","[1, 5, 4]",8,-452,"[-1, -1, 10]","[1, 5, 4]",8,-346,"[-10, -10, -10, -10, -10, -10, -10, -10, -10, -10]","[3, 3, 3, 3, 3, 3, 3, 3, 3, 3]",-100,-348,"[-10, -10, -10, -10, -10, -10, -10, -10, -10, -10]","[2, 2, 2, 2, 2, 2, 2, 2, 2, 2]",-100,-452,"[-1, -1, -1, -1, -1, 10]","[0, 2, 2, 1, 5, 4]",5,-131
"[-1, -1, 10]","[1, 5, 4]",8,-444,"[-1, -1, 10]","[0, 2, 4]",8,-338,"[-1, -1, 10]","[0, 2, 4]",8,-340,"[-1, -1, 10]","[1, 5, 4]",8,-444,"[-10, -10, -10, -10, -10, -10, -10, -10, -10, -10]","[2, 2, 2, 2, 2, 2, 2, 2, 2, 2]",-100,-231
"[-1, -1, 10]","[1, 5, 4]",8,-436,"[-1, -1, 10]","[1, 5, 4]",8,-330,"[-1, -1, 10]","[1, 5, 4]",8,-332,"[-1, -1, 10]","[1, 5, 4]",8,-436,"[-1, -1, 10]","[0, 2, 4]",8,-223
"[-1, -1, -1, 10]","[0, 1, 5, 4]",7,-429,"[-1, -1, 10]","[0, 3, 4]",8,-322,"[-1, -1, 10]","[1, 5, 4]",8,-324,"[-10, -10, -10, -10, -10, -10, -10, -10, -10, -10]","[3, 3, 3, 3, 3, 3, 3, 3, 3, 3]",-100,-536,"[-1, -1, 10]","[1, 5, 4]",8,-215
"[-1, -1, 10]","[0, 2, 4]",8,-421,"[-10, -10, -10, -10, -10, -10, -10, -10, -10, -10]","[2, 2, 2, 2, 2, 2, 2, 2, 2, 2]",-100,-422,"[-1, -1, 10]","[1, 5, 4]",8,-316,"[-1, -1, 10]","[0, 2, 4]",8,-528,"[-1, -1, 10]","[1, 5, 4]",8,-207
"[-1, -1, 10]","[0, 2, 4]",8,-413,"[-1, -1, 10]","[1, 5, 4]",8,-414,"[-10, -10, -10, -10, -10, -10, -10, -10, -10, -10]","[2, 2, 2, 2, 2, 2, 2, 2, 2, 2]",-100,-416,"[-1, -1, 10]","[0, 3, 4]",8,-520,"[-10, -10, -10, -10, -10, -10, -10, -10, -10, -10]","[3, 3, 3, 3, 3, 3, 3, 3, 3, 3]",-100,-307
"[-1, -1, 10]","[1, 5, 4]",8,-405,"[-1, -1, -1, 10]","[0, 4, 2, 4]",7,-407,"[-10, -10, -10, -10, -10, -10, -10, -10, -10, -10]","[3, 3, 3, 3, 3, 3, 3, 3, 3, 3]",-100,-516,"[-1, -1, -1, 10]","[0, 4, 2, 4]",7,-513,"[-1, -1, 10]","[1, 5, 4]",8,-299
"[-10, -10, -10, -10, -10, -10, -10, -10, -10, -10]","[3, 3, 3, 3, 3, 3, 3, 3, 3, 3]",-100,-505,"[-1, -1, -1, 10]","[0, 4, 2, 4]",7,-400,"[-10, -10, -10, -10, -10, -10, -10, -10, -10, -10]","[3, 3, 3, 3, 3, 3, 3, 3, 3, 3]",-100,-616,"[-10, -10, -10, -10, -10, -10, -10, -10, -10, -10]","[3, 3, 3, 3, 3, 3, 3, 3, 3, 3]",-100,-613,"[-10, -10, -10, -10, -10, -10, -10, -10, -10, -10]","[3, 3, 3, 3, 3, 3, 3, 3, 3, 3]",-100,-399
"[-1, -1, 10]","[1, 5, 4]",8,-497,"[-1, -1, 10]","[1, 5, 4]",8,-392,"[-1, -1, -1, -1, -1, 10]","[0, 2, 2, 1, 5, 4]",5,-611,"[-1, -1, 10]","[0, 2, 4]",8,-605,"[-1, -1, -1, -1, 10]","[0, 2, 1, 5, 4]",6,-393
"[-10, -10, -10, -10, -10, -10, -10, -10, -10, -10]","[3, 3, 3, 3, 3, 3, 3, 3, 3, 3]",-100,-597,"[-10, -10, -10, -10, -10, -10, -10, -10, -10, -10]","[3, 3, 3, 3, 3, 3, 3, 3, 3, 3]",-100,-492,"[-1, -1, 10]","[1, 5, 4]",8,-603,"[-10, -10, -10, -10, -10, -10, -10, -10, -10, -10]","[2, 2, 2, 2, 2, 2, 2, 2, 2, 2]",-100,-705,"[-10, -10, -10, -10, -10, -10, -10, -10, -10, -10]","[2, 2, 2, 2, 2, 2, 2, 2, 2, 2]",-100,-493
"[-1, -1, 10]","[1, 5, 4]",8,-589,"[-10, -10, -10, -10, -10, -10, -10, -10, -10, -10]","[3, 3, 3, 3, 3, 3, 3, 3, 3, 3]",-100,-592,"[-1, -1, 10]","[1, 5, 4]",8,-595,"[-10, -10, -10, -10, -10, -10, -10, -10, -10, -10]","[2, 2, 2, 2, 2, 2, 2, 2, 2, 2]",-100,-805,"[-1, -1, 10]","[1, 5, 4]",8,-485
"[-1, -1, 10]","[1, 5, 4]",8,-581,"[-1, -1, 10]","[1, 5, 4]",8,-584,"[-1, -1, 10]","[0, 2, 4]",8,-587,"[-10, -10, -10, -10, -10, -10, -10, -10, -10, -10]","[2, 2, 2, 2, 2, 2, 2, 2, 2, 2]",-100,-905,"[-10, -10, -10, -10, -10, -10, -10, -10, -10, -10]","[2, 2, 2, 2, 2, 2, 2, 2, 2, 2]",-100,-585
"[-1, -1, 10]","[1, 5, 4]",8,-573,"[-1, -1, 10]","[1, 5, 4]",8,-576,"[-10, -10, -10, -10, -10, -10, -10, -10, -10, -10]","[3, 3, 3, 3, 3, 3, 3, 3, 3, 3]",-100,-687,"[-1, -1, 10]","[0, 3, 4]",8,-897,"[-1, -1, 10]","[1, 5, 4]",8,-577
"[-10, -10, -10, -10, -10, -10, -10, -10, -10, -10]","[2, 2, 2, 2, 2, 2, 2, 2, 2, 2]",-100,-673,"[-10, -10, -10, -10, -10, -10, -10, -10, -10, -10]","[2, 2, 2, 2, 2, 2, 2, 2, 2, 2]",-100,-676,"[-1, -1, -1, -1, 10]","[0, 2, 1, 5, 4]",6,-681,"[-1, -1, 10]","[0, 3, 4]",8,-889,"[-10, -10, -10, -10, -10, -10, -10, -10, -10, -10]","[3, 3, 3, 3, 3, 3, 3, 3, 3, 3]",-100,-677
"[-1, -1, 10]","[0, 3, 4]",8,-665,"[-1, -1, -1, 10]","[0, 2, 2, 4]",7,-669,"[-1, -1, 10]","[1, 5, 4]",8,-673,"[-1, -1, -1, 10]","[0, 4, 2, 4]",7,-882,"[-1, -1, 10]","[0, 2, 4]",8,-669
"[-1, -1, 10]","[0, 2, 4]",8,-657,"[-1, -1, 10]","[1, 5, 4]",8,-661,"[-10, -10, -10, -10, -10, -10, -10, -10, -10, -10]","[2, 2, 2, 2, 2, 2, 2, 2, 2, 2]",-100,-773,"[-10, -10, -10, -10, -10, -10, -10, -10, -10, -10]","[3, 3, 3, 3, 3, 3, 3, 3, 3, 3]",-100,-982,"[-1, -1, 10]","[0, 2, 4]",8,-661
"[-1, -1, 10]","[0, 3, 4]",8,-649,"[-1, -1, 10]","[1, 5, 4]",8,-653,"[-10, -10, -10, -10, -10, -10, -10, -10, -10, -10]","[3, 3, 3, 3, 3, 3, 3, 3, 3, 3]",-100,-873,"[-1, -1, 10]","[1, 5, 4]",8,-974,"[-10, -10, -10, -10, -10, -10, -10, -10, -10, -10]","[3, 3, 3, 3, 3, 3, 3, 3, 3, 3]",-100,-761
"[-1, -1, 10]","[1, 5, 4]",8,-641,"[-1, -1, 10]","[1, 5, 4]",8,-645,"[-1, -1, 10]","[1, 5, 4]",8,-865,"[-1, -1, 10]","[0, 2, 4]",8,-966,"[-1, -1, 10]","[0, 2, 4]",8,-753
"[-10, -10, -10, -10, -10, -10, -10, -10, -10, -10]","[3, 3, 3, 3, 3, 3, 3, 3, 3, 3]",-100,-741,"[-1, -1, 10]","[1, 5, 4]",8,-637,"[-1, -1, 10]","[0, 2, 4]",8,-857,"[-10, -10, -10, -10, -10, -10, -10, -10, -10, -10]","[3, 3, 3, 3, 3, 3, 3, 3, 3, 3]",-100,-1066,"[-10, -10, -10, -10, -10, -10, -10, -10, -10, -10]","[3, 3, 3, 3, 3, 3, 3, 3, 3, 3]",-100,-853
"[-1, -1, -1, -1, 10]","[0, 2, 1, 5, 4]",6,-735,"[-1, -1, 10]","[0, 3, 4]",8,-629,"[-10, -10, -10, -10, -10, -10, -10, -10, -10, -10]","[2, 2, 2, 2, 2, 2, 2, 2, 2, 2]",-100,-957,"[-10, -10, -10, -10, -10, -10, -10, -10, -10, -10]","[2, 2, 2, 2, 2, 2, 2, 2, 2, 2]",-100,-1166,"[-1, -10, -10, -10, -10, -10, -10, -10, -10, -10]","[0, 0, 0, 0, 0, 0, 0, 0, 0, 0]",-91,-944
"[-1, -1, 10]","[0, 2, 4]",8,-727,"[-1, -1, -1, 10]","[0, 4, 2, 4]",7,-622,"[-1, -1, 10]","[1, 5, 4]",8,-949,"[-1, -1, 10]","[1, 5, 4]",8,-1158,"[-1, -1, 10]","[0, 2, 4]",8,-936
"[-1, -1, 10]","[0, 2, 4]",8,-719,"[-1, -1, 10]","[1, 5, 4]",8,-614,"[-1, -1, -1, 10]","[0, 4, 2, 4]",7,-942,"[-10, -10, -10, -10, -10, -10, -10, -10, -10, -10]","[2, 2, 2, 2, 2, 2, 2, 2, 2, 2]",-100,-1258,"[-1, -1, 10]","[0, 3, 4]",8,-928
"[-1, -1, 10]","[0, 2, 4]",8,-711,"[-1, -1, 10]","[1, 5, 4]",8,-606,"[-10, -10, -10, -10, -10, -10, -10, -10, -10, -10]","[3, 3, 3, 3, 3, 3, 3, 3, 3, 3]",-100,-1042,"[-1, -1, 10]","[0, 2, 4]",8,-1250,"[-1, -1, 10]","[1, 5, 4]",8,-920
"[-1, -1, 10]","[1, 5, 4]",8,-703,"[-10, -10, -10, -10, -10, -10, -10, -10, -10, -10]","[2, 2, 2, 2, 2, 2, 2, 2, 2, 2]",-100,-706,"[-1, -1, 10]","[0, 3, 4]",8,-1034,"[-10, -10, -10, -10, -10, -10, -10, -10, -10, -10]","[2, 2, 2, 2, 2, 2, 2, 2, 2, 2]",-100,-1350,"[-1, -10, -10, -10, -10, -10, -10, -10, -10, -10]","[1, 5, 5, 5, 5, 5, 5, 5, 5, 5]",-91,-1011
"[-1, -10, -10, -10, -10, -10, -10, -10, -10, -10]","[0, 0, 0, 0, 0, 0, 0, 0, 0, 0]",-91,-794,"[-1, -1, 10]","[0, 2, 4]",8,-698,"[-1, -1, -10, -10, -10, -10, -10, -10, -10, -10]","[0, 2, 1, 1, 1, 1, 1, 1, 1, 1]",-82,-1116,"[-1, -1, 10]","[1, 5, 4]",8,-1342,"[-1, -1, 10]","[1, 5, 4]",8,-1003
"[-1, -1, 10]","[0, 2, 4]",8,-786,"[-1, -1, -1, 10]","[0, 2, 2, 4]",7,-691,"[-1, -1, 10]","[0, 3, 4]",8,-1108,"[-1, -10, -10, -10, -10, -10, -10, -10, -10, -10]","[0, 0, 0, 0, 0, 0, 0, 0, 0, 0]",-91,-1433,"[-1, -1, -1, 10]","[0, 4, 2, 4]",7,-996
"[-1, -1, 10]","[1, 5, 4]",8,-778,"[-10, -10, -10, -10, -10, -10, -10, -10, -10, -10]","[2, 2, 2, 2, 2, 2, 2, 2, 2, 2]",-100,-791,"[-10, -10, -10, -10, -10, -10, -10, -10, -10, -10]","[2, 2, 2, 2, 2, 2, 2, 2, 2, 2]",-100,-1208,"[-10, -10, -10, -10, -10, -10, -10, -10, -10, -10]","[2, 2, 2, 2, 2, 2, 2, 2, 2, 2]",-100,-1533,"[-1, -1, 10]","[0, 3, 4]",8,-988
"[-1, -1, 10]","[0, 2, 4]",8,-770,"[-1, -10, -10, -10, -10, -10, -10, -10, -10, -10]","[0, 0, 0, 0, 0, 0, 0, 0, 0, 0]",-91,-882,"[-10, -10, -10, -10, -10, -10, -10, -10, -10, -10]","[2, 2, 2, 2, 2, 2, 2, 2, 2, 2]",-100,-1308,"[-1, -1, 10]","[1, 5, 4]",8,-1525,"[-1, -10, -10, -10, -10, -10, -10, -10, -10, -10]","[0, 0, 0, 0, 0, 0, 0, 0, 0, 0]",-91,-1079
"[-1, -1, 10]","[1, 5, 4]",8,-762,"[-10, -10, -10, -10, -10, -10, -10, -10, -10, -10]","[2, 2, 2, 2, 2, 2, 2, 2, 2, 2]",-100,-982,"[-10, -10, -10, -10, -10, -10, -10, -10, -10, -10]","[3, 3, 3, 3, 3, 3, 3, 3, 3, 3]",-100,-1408,"[-1, -1, 10]","[0, 2, 4]",8,-1517,"[-10, -10, -10, -10, -10, -10, -10, -10, -10, -10]","[2, 2, 2, 2, 2, 2, 2, 2, 2, 2]",-100,-1179
"[-1, -1, 10]","[0, 2, 4]",8,-754,"[-10, -10, -10, -10, -10, -10, -10, -10, -10, -10]","[2, 2, 2, 2, 2, 2, 2, 2, 2, 2]",-100,-1082,"[-1, -1, -1, 10]","[0, 4, 2, 4]",7,-1401,"[-1, -1, 10]","[0, 3, 4]",8,-1509,"[-1, -1, 10]","[1, 5, 4]",8,-1171
"[-10, -10, -10, -10, -10, -10, -10, -10, -10, -10]","[2, 2, 2, 2, 2, 2, 2, 2, 2, 2]",-100,-854,"[-1, -1, 10]","[0, 2, 4]",8,-1074,"[-1, -1, 10]","[1, 5, 4]",8,-1393,"[-1, -1, 10]","[1, 5, 4]",8,-1501,"[-1, -1, 10]","[1, 5, 4]",8,-1163
"[-10, -10, -10, -10, -10, -10, -10, -10, -10, -10]","[3, 3, 3, 3, 3, 3, 3, 3, 3, 3]",-100,-954,"[-1, -1, 10]","[0, 2, 4]",8,-1066,"[-1, -1, 10]","[1, 5, 4]",8,-1385,"[-1, -1, 10]","[1, 5, 4]",8,-1493,"[-1, -1, 10]","[1, 5, 4]",8,-1155
"[-1, -1, 10]","[1, 5, 4]",8,-946,"[-10, -10, -10, -10, -10, -10, -10, -10, -10, -10]","[2, 2, 2, 2, 2, 2, 2, 2, 2, 2]",-100,-1166,"[-1, -1, 10]","[1, 5, 4]",8,-1377,"[-1, -1, 10]","[1, 5, 4]",8,-1485,"[-1, -1, 10]","[1, 5, 4]",8,-1147
"[-1, -1, 10]","[1, 5, 4]",8,-938,"[-10, -10, -10, -10, -10, -10, -10, -10, -10, -10]","[2, 2, 2, 2, 2, 2, 2, 2, 2, 2]",-100,-1266,"[-10, -10, -10, -10, -10, -10, -10, -10, -10, -10]","[3, 3, 3, 3, 3, 3, 3, 3, 3, 3]",-100,-1477,"[-1, -1, 10]","[0, 2, 4]",8,-1477,"[-1, -1, 10]","[1, 5, 4]",8,-1139
"[-10, -10, -10, -10, -10, -10, -10, -10, -10, -10]","[2, 2, 2, 2, 2, 2, 2, 2, 2, 2]",-100,-1038,"[-10, -10, -10, -10, -10, -10, -10, -10, -10, -10]","[2, 2, 2, 2, 2, 2, 2, 2, 2, 2]",-100,-1366,"[-1, -1, -1, -1, 10]","[0, 2, 1, 5, 4]",6,-1471,"[-10, -10, -10, -10, -10, -10, -10, -10, -10, -10]","[3, 3, 3, 3, 3, 3, 3, 3, 3, 3]",-100,-1577,"[-1, -1, -1, 10]","[0, 4, 2, 4]",7,-1132
"[-10, -10, -10, -10, -10, -10, -10, -10, -10, -10]","[3, 3, 3, 3, 3, 3, 3, 3, 3, 3]",-100,-1138,"[-10, -10, -10, -10, -10, -10, -10, -10, -10, -10]","[2, 2, 2, 2, 2, 2, 2, 2, 2, 2]",-100,-1466,"[-1, -1, 10]","[0, 3, 4]",8,-1463,"[-10, -10, -10, -10, -10, -10, -10, -10, -10, -10]","[2, 2, 2, 2, 2, 2, 2, 2, 2, 2]",-100,-1677,"[-10, -10, -10, -10, -10, -10, -10, -10, -10, -10]","[2, 2, 2, 2, 2, 2, 2, 2, 2, 2]",-100,-1232
"[-1, -1, -1, 10]","[0, 4, 2, 4]",7,-1131,"[-10, -10, -10, -10, -10, -10, -10, -10, -10, -10]","[3, 3, 3, 3, 3, 3, 3, 3, 3, 3]",-100,-1566,"[-10, -10, -10, -10, -10, -10, -10, -10, -10, -10]","[3, 3, 3, 3, 3, 3, 3, 3, 3, 3]",-100,-1563,"[-10, -10, -10, -10, -10, -10, -10, -10, -10, -10]","[2, 2, 2, 2, 2, 2, 2, 2, 2, 2]",-100,-1777,"[-10, -10, -10, -10, -10, -10, -10, -10, -10, -10]","[2, 2, 2, 2, 2, 2, 2, 2, 2, 2]",-100,-1332
"[-1, -1, 10]","[0, 3, 4]",8,-1123,"[-1, -1, 10]","[1, 5, 4]",8,-1558,"[-1, -1, 10]","[1, 5, 4]",8,-1555,"[-10, -10, -10, -10, -10, -10, -10, -10, -10, -10]","[3, 3, 3, 3, 3, 3, 3, 3, 3, 3]",-100,-1877,"[-1, -1, 10]","[1, 5, 4]",8,-1324
"[-1, -1, 10]","[1, 5, 4]",8,-1115,"[-1, -1, 10]","[1, 5, 4]",8,-1550,"[-10, -10, -10, -10, -10, -10, -10, -10, -10, -10]","[2, 2, 2, 2, 2, 2, 2, 2, 2, 2]",-100,-1655,"[-1, -1, 10]","[1, 5, 4]",8,-1869,"[-1, -1, 10]","[1, 5, 4]",8,-1316
"[-1, -1, 10]","[1, 5, 4]",8,-1107,"[-10, -10, -10, -10, -10, -10, -10, -10, -10, -10]","[3, 3, 3, 3, 3, 3, 3, 3, 3, 3]",-100,-1650,"[-1, -10, -10, -10, -10, -10, -10, -10, -10, -10]","[0, 0, 0, 0, 0, 0, 0, 0, 0, 0]",-91,-1746,"[-1, -1, 10]","[0, 2, 4]",8,-1861,"[-1, -1, 10]","[1, 5, 4]",8,-1308
"[-10, -10, -10, -10, -10, -10, -10, -10, -10, -10]","[2, 2, 2, 2, 2, 2, 2, 2, 2, 2]",-100,-1207,"[-1, -1, 10]","[1, 5, 4]",8,-1642,"[-10, -10, -10, -10, -10, -10, -10, -10, -10, -10]","[2, 2, 2, 2, 2, 2, 2, 2, 2, 2]",-100,-1846,"[-10, -10, -10, -10, -10, -10, -10, -10, -10, -10]","[2, 2, 2, 2, 2, 2, 2, 2, 2, 2]",-100,-1961,"[-10, -10, -10, -10, -10, -10, -10, -10, -10, -10]","[3, 3, 3, 3, 3, 3, 3, 3, 3, 3]",-100,-1408
"[-10, -10, -10, -10, -10, -10, -10, -10, -10, -10]","[2, 2, 2, 2, 2, 2, 2, 2, 2, 2]",-100,-1307,"[-10, -10, -10, -10, -10, -10, -10, -10, -10, -10]","[2, 2, 2, 2, 2, 2, 2, 2, 2, 2]",-100,-1742,"[-10, -10, -10, -10, -10, -10, -10, -10, -10, -10]","[2, 2, 2, 2, 2, 2, 2, 2, 2, 2]",-100,-1946,"[-1, -1, 10]","[0, 2, 4]",8,-1953,"[-1, -1, 10]","[0, 3, 4]",8,-1400
"[-1, -1, 10]","[1, 5, 4]",8,-1299,"[-1, -1, -1, 10]","[0, 2, 2, 4]",7,-1735,"[-1, -1, 10]","[1, 5, 4]",8,-1938,"[-1, -1, 10]","[1, 5, 4]",8,-1945,"[-10, -10, -10, -10, -10, -10, -10, -10, -10, -10]","[2, 2, 2, 2, 2, 2, 2, 2, 2, 2]",-100,-1500
"[-1, -1, 10]","[0, 2, 4]",8,-1291,"[-1, -1, 10]","[1, 5, 4]",8,-1727,"[-1, -1, 10]","[1, 5, 4]",8,-1930,"[-10, -10, -10, -10, -10, -10, -10, -10, -10, -10]","[2, 2, 2, 2, 2, 2, 2, 2, 2, 2]",-100,-2045,"[-10, -10, -10, -10, -10, -10, -10, -10, -10, -10]","[2, 2, 2, 2, 2, 2, 2, 2, 2, 2]",-100,-1600
"[-10, -10, -10, -10, -10, -10, -10, -10, -10, -10]","[3, 3, 3, 3, 3, 3, 3, 3, 3, 3]",-100,-1391,"[-1, -1, 10]","[1, 5, 4]",8,-1719,"[-10, -10, -10, -10, -10, -10, -10, -10, -10, -10]","[2, 2, 2, 2, 2, 2, 2, 2, 2, 2]",-100,-2030,"[-1, -1, 10]","[1, 5, 4]",8,-2037,"[-1, -1, 10]","[0, 2, 4]",8,-1592
"[-10, -10, -10, -10, -10, -10, -10, -10, -10, -10]","[2, 2, 2, 2, 2, 2, 2, 2, 2, 2]",-100,-1491,"[-10, -10, -10, -10, -10, -10, -10, -10, -10, -10]","[3, 3, 3, 3, 3, 3, 3, 3, 3, 3]",-100,-1819,"[-10, -10, -10, -10, -10, -10, -10, -10, -10, -10]","[2, 2, 2, 2, 2, 2, 2, 2, 2, 2]",-100,-2130,"[-1, -1, 10]","[1, 5, 4]",8,-2029,"[-1, -1, 10]","[0, 2, 4]",8,-1584
"[-1, -1, 10]","[1, 5, 4]",8,-1483,"[-1, -1, 10]","[1, 5, 4]",8,-1811,"[-10, -10, -10, -10, -10, -10, -10, -10, -10, -10]","[2, 2, 2, 2, 2, 2, 2, 2, 2, 2]",-100,-2230,"[-10, -10, -10, -10, -10, -10, -10, -10, -10, -10]","[3, 3, 3, 3, 3, 3, 3, 3, 3, 3]",-100,-2129,"[-1, -1, 10]","[0, 2, 4]",8,-1576
"[-1, -1, 10]","[0, 3, 4]",8,-1475,"[-10, -10, -10, -10, -10, -10, -10, -10, -10, -10]","[2, 2, 2, 2, 2, 2, 2, 2, 2, 2]",-100,-1911,"[-1, -1, 10]","[0, 2, 4]",8,-2222,"[-1, -1, -1, 10]","[0, 2, 2, 4]",7,-2122,"[-1, -1, 10]","[1, 5, 4]",8,-1568
"[-1, -1, 10]","[0, 3, 4]",8,-1467,"[-1, -1, 10]","[1, 5, 4]",8,-1903,"[-10, -10, -10, -10, -10, -10, -10, -10, -10, -10]","[3, 3, 3, 3, 3, 3, 3, 3, 3, 3]",-100,-2322,"[-10, -10, -10, -10, -10, -10, -10, -10, -10, -10]","[2, 2, 2, 2, 2, 2, 2, 2, 2, 2]",-100,-2222,"[-1, -1, 10]","[1, 5, 4]",8,-1560
"[-10, -10, -10, -10, -10, -10, -10, -10, -10, -10]","[3, 3, 3, 3, 3, 3, 3, 3, 3, 3]",-100,-1567,"[-10, -10, -10, -10, -10, -10, -10, -10, -10, -10]","[3, 3, 3, 3, 3, 3, 3, 3, 3, 3]",-100,-2003,"[-10, -10, -10, -10, -10, -10, -10, -10, -10, -10]","[3, 3, 3, 3, 3, 3, 3, 3, 3, 3]",-100,-2422,"[-1, -1, -1, 10]","[0, 2, 2, 4]",7,-2215,"[-1, -10, -10, -10, -10, -10, -10, -10, -10, -10]","[0, 0, 0, 0, 0, 0, 0, 0, 0, 0]",-91,-1651
"[-1, -1, 10]","[0, 3, 4]",8,-1559,"[-10, -10, -10, -10, -10, -10, -10, -10, -10, -10]","[3, 3, 3, 3, 3, 3, 3, 3, 3, 3]",-100,-2103,"[-1, -1, 10]","[1, 5, 4]",8,-2414,"[-1, -1, 10]","[1, 5, 4]",8,-2207,"[-1, -1, 10]","[1, 5, 4]",8,-1643
"[-1, -1, 10]","[1, 5, 4]",8,-1551,"[-1, -10, -10, -10, -10, -10, -10, -10, -10, -10]","[0, 0, 0, 0, 0, 0, 0, 0, 0, 0]",-91,-2194,"[-10, -10, -10, -10, -10, -10, -10, -10, -10, -10]","[3, 3, 3, 3, 3, 3, 3, 3, 3, 3]",-100,-2514,"[-10, -10, -10, -10, -10, -10, -10, -10, -10, -10]","[3, 3, 3, 3, 3, 3, 3, 3, 3, 3]",-100,-2307,"[-1, -1, -1, 10]","[0, 4, 2, 4]",7,-1636
"[-1, -1, 10]","[1, 5, 4]",8,-1543,"[-10, -10, -10, -10, -10, -10, -10, -10, -10, -10]","[2, 2, 2, 2, 2, 2, 2, 2, 2, 2]",-100,-2294,"[-1, -1, 10]","[1, 5, 4]",8,-2506,"[-1, -1, 10]","[1, 5, 4]",8,-2299,"[-10, -10, -10, -10, -10, -10, -10, -10, -10, -10]","[2, 2, 2, 2, 2, 2, 2, 2, 2, 2]",-100,-1736
"[-1, -1, 10]","[1, 5, 4]",8,-1535,"[-1, -1, 10]","[0, 2, 4]",8,-2286,"[-1, -1, 10]","[1, 5, 4]",8,-2498,"[-1, -1, 10]","[1, 5, 4]",8,-2291,"[-1, -1, 10]","[0, 3, 4]",8,-1728
"[-1, -1, 10]","[0, 2, 4]",8,-1527,"[-10, -10, -10, -10, -10, -10, -10, -10, -10, -10]","[2, 2, 2, 2, 2, 2, 2, 2, 2, 2]",-100,-2386,"[-1, -1, -1, 10]","[0, 4, 2, 4]",7,-2491,"[-1, -1, 10]","[0, 2, 4]",8,-2283,"[-10, -10, -10, -10, -10, -10, -10, -10, -10, -10]","[3, 3, 3, 3, 3, 3, 3, 3, 3, 3]",-100,-1828
"[-1, -1, 10]","[1, 5, 4]",8,-1519,"[-1, -1, 10]","[0, 3, 4]",8,-2378,"[-10, -10, -10, -10, -10, -10, -10, -10, -10, -10]","[3, 3, 3, 3, 3, 3, 3, 3, 3, 3]",-100,-2591,"[-1, -1, 10]","[1, 5, 4]",8,-2275,"[-1, -1, 10]","[1, 5, 4]",8,-1820
"[-10, -10, -10, -10, -10, -10, -10, -10, -10, -10]","[2, 2, 2, 2, 2, 2, 2, 2, 2, 2]",-100,-1619,"[-10, -10, -10, -10, -10, -10, -10, -10, -10, -10]","[3, 3, 3, 3, 3, 3, 3, 3, 3, 3]",-100,-2478,"[-1, -1, 10]","[1, 5, 4]",8,-2583,"[-10, -10, -10, -10, -10, -10, -10, -10, -10, -10]","[3, 3, 3, 3, 3, 3, 3, 3, 3, 3]",-100,-2375,"[-1, -1, 10]","[0, 2, 4]",8,-1812
"[-10, -10, -10, -10, -10, -10, -10, -10, -10, -10]","[2, 2, 2, 2, 2, 2, 2, 2, 2, 2]",-100,-1719,"[-10, -10, -10, -10, -10, -10, -10, -10, -10, -10]","[2, 2, 2, 2, 2, 2, 2, 2, 2, 2]",-100,-2578,"[-10, -10, -10, -10, -10, -10, -10, -10, -10, -10]","[2, 2, 2, 2, 2, 2, 2, 2, 2, 2]",-100,-2683,"[-1, -1, 10]","[0, 2, 4]",8,-2367,"[-1, -1, 10]","[0, 2, 4]",8,-1804
"[-1, -1, 10]","[1, 5, 4]",8,-1711,"[-10, -10, -10, -10, -10, -10, -10, -10, -10, -10]","[3, 3, 3, 3, 3, 3, 3, 3, 3, 3]",-100,-2678,"[-1, -1, 10]","[1, 5, 4]",8,-2675,"[-1, -1, 10]","[0, 2, 4]",8,-2359,"[-10, -10, -10, -10, -10, -10, -10, -10, -10, -10]","[2, 2, 2, 2, 2, 2, 2, 2, 2, 2]",-100,-1904
"[-10, -10, -10, -10, -10, -10, -10, -10, -10, -10]","[2, 2, 2, 2, 2, 2, 2, 2, 2, 2]",-100,-1811,"[-10, -10, -10, -10, -10, -10, -10, -10, -10, -10]","[2, 2, 2, 2, 2, 2, 2, 2, 2, 2]",-100,-2778,"[-10, -10, -10, -10, -10, -10, -10, -10, -10, -10]","[3, 3, 3, 3, 3, 3, 3, 3, 3, 3]",-100,-2775,"[-1, -1, 10]","[1, 5, 4]",8,-2351,"[-10, -10, -10, -10, -10, -10, -10, -10, -10, -10]","[3, 3, 3, 3, 3, 3, 3, 3, 3, 3]",-100,-2004
"[-10, -10, -10, -10, -10, -10, -10, -10, -10, -10]","[3, 3, 3, 3, 3, 3, 3, 3, 3, 3]",-100,-1911,"[-1, -1, 10]","[0, 2, 4]",8,-2770,"[-1, -1, 10]","[1, 5, 4]",8,-2767,"[-10, -10, -10, -10, -10, -10, -10, -10, -10, -10]","[2, 2, 2, 2, 2, 2, 2, 2, 2, 2]",-100,-2451,"[-1, -1, 10]","[1, 5, 4]",8,-1996
"[-1, -1, 10]","[0, 2, 4]",8,-1903,"[-1, -1, -1, 10]","[0, 4, 2, 4]",7,-2763,"[-1, -1, 10]","[1, 5, 4]",8,-2759,"[-1, -1, 10]","[1, 5, 4]",8,-2443,"[-1, -1, 10]","[0, 3, 4]",8,-1988
"[-1, -1, -1, 10]","[0, 2, 2, 4]",7,-1896,"[-10, -10, -10, -10, -10, -10, -10, -10, -10, -10]","[2, 2, 2, 2, 2, 2, 2, 2, 2, 2]",-100,-2863,"[-1, -1, 10]","[0, 2, 4]",8,-2751,"[-1, -1, 10]","[1, 5, 4]",8,-2435,"[-10, -10, -10, -10, -10, -10, -10, -10, -10, -10]","[2, 2, 2, 2, 2, 2, 2, 2, 2, 2]",-100,-2088
"[-1, -1, 10]","[0, 2, 4]",8,-1888,"[-10, -10, -10, -10, -10, -10, -10, -10, -10, -10]","[2, 2, 2, 2, 2, 2, 2, 2, 2, 2]",-100,-2963,"[-1, -1, 10]","[1, 5, 4]",8,-2743,"[-1, -1, 10]","[0, 2, 4]",8,-2427,"[-10, -10, -10, -10, -10, -10, -10, -10, -10, -10]","[2, 2, 2, 2, 2, 2, 2, 2, 2, 2]",-100,-2188
"[-10, -10, -10, -10, -10, -10, -10, -10, -10, -10]","[3, 3, 3, 3, 3, 3, 3, 3, 3, 3]",-100,-1988,"[-10, -10, -10, -10, -10, -10, -10, -10, -10, -10]","[2, 2, 2, 2, 2, 2, 2, 2, 2, 2]",-100,-3063,"[-1, -1, 10]","[0, 2, 4]",8,-2735,"[-10, -10, -10, -10, -10, -10, -10, -10, -10, -10]","[2, 2, 2, 2, 2, 2, 2, 2, 2, 2]",-100,-2527,"[-1, -1, 10]","[1, 5, 4]",8,-2180
"[-1, -1, 10]","[1, 5, 4]",8,-1980,"[-1, -1, 10]","[1, 5, 4]",8,-3055,"[-1, -1, 10]","[1, 5, 4]",8,-2727,"[-10, -10, -10, -10, -10, -10, -10, -10, -10, -10]","[2, 2, 2, 2, 2, 2, 2, 2, 2, 2]",-100,-2627,"[-10, -10, -10, -10, -10, -10, -10, -10, -10, -10]","[2, 2, 2, 2, 2, 2, 2, 2, 2, 2]",-100,-2280
"[-10, -10, -10, -10, -10, -10, -10, -10, -10, -10]","[3, 3, 3, 3, 3, 3, 3, 3, 3, 3]",-100,-2080,"[-1, -1, 10]","[1, 5, 4]",8,-3047,"[-1, -1, 10]","[1, 5, 4]",8,-2719,"[-10, -10, -10, -10, -10, -10, -10, -10, -10, -10]","[3, 3, 3, 3, 3, 3, 3, 3, 3, 3]",-100,-2727,"[-10, -10, -10, -10, -10, -10, -10, -10, -10, -10]","[2, 2, 2, 2, 2, 2, 2, 2, 2, 2]",-100,-2380
"[-1, -1, -1, 10]","[0, 2, 2, 4]",7,-2073,"[-1, -1, -1, -1, -1, 10]","[0, 2, 2, 1, 5, 4]",5,-3042,"[-10, -10, -10, -10, -10, -10, -10, -10, -10, -10]","[3, 3, 3, 3, 3, 3, 3, 3, 3, 3]",-100,-2819,"[-1, -1, 10]","[0, 3, 4]",8,-2719,"[-1, -1, 10]","[1, 5, 4]",8,-2372
"[-1, -1, 10]","[1, 5, 4]",8,-2065,"[-1, -1, 10]","[0, 3, 4]",8,-3034,"[-10, -10, -10, -10, -10, -10, -10, -10, -10, -10]","[2, 2, 2, 2, 2, 2, 2, 2, 2, 2]",-100,-2919,"[-10, -10, -10, -10, -10, -10, -10, -10, -10, -10]","[2, 2, 2, 2, 2, 2, 2, 2, 2, 2]",-100,-2819,"[-1, -10, -10, -10, -10, -10, -10, -10, -10, -10]","[1, 5, 5, 5, 5, 5, 5, 5, 5, 5]",-91,-2463
"[-10, -10, -10, -10, -10, -10, -10, -10, -10, -10]","[2, 2, 2, 2, 2, 2, 2, 2, 2, 2]",-100,-2165,"[-10, -10, -10, -10, -10, -10, -10, -10, -10, -10]","[2, 2, 2, 2, 2, 2, 2, 2, 2, 2]",-100,-3134,"[-1, -1, 10]","[1, 5, 4]",8,-2911,"[-1, -1, -1, 10]","[0, 4, 2, 4]",7,-2812,"[-10, -10, -10, -10, -10, -10, -10, -10, -10, -10]","[2, 2, 2, 2, 2, 2, 2, 2, 2, 2]",-100,-2563
"[-1, -1, 10]","[1, 5, 4]",8,-2157,"[-10, -10, -10, -10, -10, -10, -10, -10, -10, -10]","[3, 3, 3, 3, 3, 3, 3, 3, 3, 3]",-100,-3234,"[-1, -1, 10]","[0, 3, 4]",8,-2903,"[-1, -1, 10]","[1, 5, 4]",8,-2804,"[-1, -1, 10]","[0, 2, 4]",8,-2555
"[-1, -1, -1, 10]","[0, 4, 2, 4]",7,-2150,"[-1, -1, 10]","[1, 5, 4]",8,-3226,"[-1, -1, -1, 10]","[0, 4, 2, 4]",7,-2896,"[-10, -10, -10, -10, -10, -10, -10, -10, -10, -10]","[3, 3, 3, 3, 3, 3, 3, 3, 3, 3]",-100,-2904,"[-10, -10, -10, -10, -10, -10, -10, -10, -10, -10]","[2, 2, 2, 2, 2, 2, 2, 2, 2, 2]",-100,-2655
"[-10, -10, -10, -10, -10, -10, -10, -10, -10, -10]","[2, 2, 2, 2, 2, 2, 2, 2, 2, 2]",-100,-2250,"[-1, -1, -1, 10]","[0, 2, 2, 4]",7,-3219,"[-1, -1, 10]","[0, 2, 4]",8,-2888,"[-1, -1, 10]","[1, 5, 4]",8,-2896,"[-1, -1, 10]","[0, 3, 4]",8,-2647
"[-10, -10, -10, -10, -10, -10, -10, -10, -10, -10]","[2, 2, 2, 2, 2, 2, 2, 2, 2, 2]",-100,-2350,"[-1, -1, 10]","[1, 5, 4]",8,-3211,"[-1, -1, -1, 10]","[0, 4, 2, 4]",7,-2881,"[-10, -10, -10, -10, -10, -10, -10, -10, -10, -10]","[2, 2, 2, 2, 2, 2, 2, 2, 2, 2]",-100,-2996,"[-1, -1, -1, 10]","[0, 4, 2, 4]",7,-2640
"[-10, -10, -10, -10, -10, -10, -10, -10, -10, -10]","[2, 2, 2, 2, 2, 2, 2, 2, 2, 2]",-100,-2450,"[-1, -1, 10]","[1, 5, 4]",8,-3203,"[-10, -10, -10, -10, -10, -10, -10, -10, -10, -10]","[2, 2, 2, 2, 2, 2, 2, 2, 2, 2]",-100,-2981,"[-10, -10, -10, -10, -10, -10, -10, -10, -10, -10]","[2, 2, 2, 2, 2, 2, 2, 2, 2, 2]",-100,-3096,"[-1, -1, 10]","[1, 5, 4]",8,-2632
"[-10, -10, -10, -10, -10, -10, -10, -10, -10, -10]","[2, 2, 2, 2, 2, 2, 2, 2, 2, 2]",-100,-2550,"[-1, -1, 10]","[1, 5, 4]",8,-3195,"[-1, -10, -10, -10, -10, -10, -10, -10, -10, -10]","[1, 5, 5, 5, 5, 5, 5, 5, 5, 5]",-91,-3072,"[-1, -1, 10]","[1, 5, 4]",8,-3088,"[-1, -1, 10]","[1, 5, 4]",8,-2624
"[-1, -1, 10]","[1, 5, 4]",8,-2542,"[-1, -1, -1, 10]","[0, 2, 2, 4]",7,-3188,"[-1, -1, 10]","[1, 5, 4]",8,-3064,"[-1, -1, 10]","[0, 3, 4]",8,-3080,"[-10, -10, -10, -10, -10, -10, -10, -10, -10, -10]","[3, 3, 3, 3, 3, 3, 3, 3, 3, 3]",-100,-2724
"[-1, -1, 10]","[0, 3, 4]",8,-2534,"[-1, -1, 10]","[1, 5, 4]",8,-3180,"[-1, -1, -1, -1, -1, 10]","[0, 2, 2, 1, 5, 4]",5,-3059,"[-1, -1, 10]","[1, 5, 4]",8,-3072,"[-1, -1, 10]","[0, 2, 4]",8,-2716
"[-1, -1, 10]","[1, 5, 4]",8,-2526,"[-1, -1, 10]","[0, 3, 4]",8,-3172,"[-1, -1, 10]","[1, 5, 4]",8,-3051,"[-1, -1, 10]","[1, 5, 4]",8,-3064,"[-1, -1, 10]","[1, 5, 4]",8,-2708
"[-1, -1, 10]","[0, 3, 4]",8,-2518,"[-1, -1, 10]","[0, 2, 4]",8,-3164,"[-1, -1, 10]","[1, 5, 4]",8,-3043,"[-1, -1, 10]","[1, 5, 4]",8,-3056,"[-10, -10, -10, -10, -10, -10, -10, -10, -10, -10]","[3, 3, 3, 3, 3, 3, 3, 3, 3, 3]",-100,-2808
"[-10, -10, -10, -10, -10, -10, -10, -10, -10, -10]","[2, 2, 2, 2, 2, 2, 2, 2, 2, 2]",-100,-2618,"[-1, -1, 10]","[0, 3, 4]",8,-3156,"[-1, -1, 10]","[1, 5, 4]",8,-3035,"[-1, -1, -1, 10]","[0, 4, 2, 4]",7,-3049,"[-10, -10, -10, -10, -10, -10, -10, -10, -10, -10]","[2, 2, 2, 2, 2, 2, 2, 2, 2, 2]",-100,-2908
"[-1, -10, -10, -10, -10, -10, -10, -10, -10, -10]","[0, 0, 0, 0, 0, 0, 0, 0, 0, 0]",-91,-2709,"[-1, -1, 10]","[0, 2, 4]",8,-3148,"[-1, -1, -1, 10]","[0, 2, 2, 4]",7,-3028,"[-1, -1, 10]","[1, 5, 4]",8,-3041,"[-1, -1, 10]","[1, 5, 4]",8,-2900
"[-1, -1, 10]","[1, 5, 4]",8,-2701,"[-1, -1, 10]","[0, 3, 4]",8,-3140,"[-1, -1, 10]","[1, 5, 4]",8,-3020,"[-1, -1, 10]","[1, 5, 4]",8,-3033,"[-10, -10, -10, -10, -10, -10, -10, -10, -10, -10]","[3, 3, 3, 3, 3, 3, 3, 3, 3, 3]",-100,-3000
"[-1, -1, 10]","[0, 3, 4]",8,-2693,"[-1, -1, -1, -1, -1, 10]","[0, 2, 2, 1, 5, 4]",5,-3135,"[-10, -10, -10, -10, -10, -10, -10, -10, -10, -10]","[2, 2, 2, 2, 2, 2, 2, 2, 2, 2]",-100,-3120,"[-1, -1, 10]","[1, 5, 4]",8,-3025,"[-10, -10, -10, -10, -10, -10, -10, -10, -10, -10]","[3, 3, 3, 3, 3, 3, 3, 3, 3, 3]",-100,-3100
"[-1, -1, 10]","[1, 5, 4]",8,-2685,"[-1, -1, 10]","[1, 5, 4]",8,-3127,"[-1, -1, 10]","[1, 5, 4]",8,-3112,"[-1, -1, 10]","[1, 5, 4]",8,-3017,"[-1, -1, -1, 10]","[0, 4, 2, 4]",7,-3093
"[-10, -10, -10, -10, -10, -10, -10, -10, -10, -10]","[2, 2, 2, 2, 2, 2, 2, 2, 2, 2]",-100,-2785,"[-10, -10, -10, -10, -10, -10, -10, -10, -10, -10]","[3, 3, 3, 3, 3, 3, 3, 3, 3, 3]",-100,-3227,"[-1, -1, 10]","[1, 5, 4]",8,-3104,"[-1, -1, 10]","[1, 5, 4]",8,-3009,"[-1, -1, 10]","[1, 5, 4]",8,-3085
"[-1, -1, 10]","[0, 2, 4]",8,-2777,"[-1, -1, 10]","[1, 5, 4]",8,-3219,"[-1, -1, 10]","[1, 5, 4]",8,-3096,"[-1, -1, 10]","[0, 2, 4]",8,-3001,"[-1, -1, 10]","[1, 5, 4]",8,-3077
"[-1, -1, 10]","[1, 5, 4]",8,-2769,"[-1, -1, 10]","[0, 2, 4]",8,-3211,"[-10, -10, -10, -10, -10, -10, -10, -10, -10, -10]","[2, 2, 2, 2, 2, 2, 2, 2, 2, 2]",-100,-3196,"[-1, -1, 10]","[1, 5, 4]",8,-2993,"[-10, -10, -10, -10, -10, -10, -10, -10, -10, -10]","[3, 3, 3, 3, 3, 3, 3, 3, 3, 3]",-100,-3177
"[-10, -10, -10, -10, -10, -10, -10, -10, -10, -10]","[2, 2, 2, 2, 2, 2, 2, 2, 2, 2]",-100,-2869,"[-1, -1, 10]","[0, 3, 4]",8,-3203,"[-1, -1, 10]","[1, 5, 4]",8,-3188,"[-1, -1, 10]","[1, 5, 4]",8,-2985,"[-1, -1, 10]","[0, 2, 4]",8,-3169
"[-1, -1, -1, 10]","[0, 1, 5, 4]",7,-2862,"[-10, -10, -10, -10, -10, -10, -10, -10, -10, -10]","[3, 3, 3, 3, 3, 3, 3, 3, 3, 3]",-100,-3303,"[-10, -10, -10, -10, -10, -10, -10, -10, -10, -10]","[2, 2, 2, 2, 2, 2, 2, 2, 2, 2]",-100,-3288,"[-1, -1, 10]","[0, 3, 4]",8,-2977,"[-10, -10, -10, -10, -10, -10, -10, -10, -10, -10]","[2, 2, 2, 2, 2, 2, 2, 2, 2, 2]",-100,-3269
