0,1,2,3,4,5,6,7,8,9,10,11,12,13,14,15,16,17,18,19
"[-10, -10, -10, -10, -10, -10, -10, -10, -10, -10]","[5, 5, 5, 5, 5, 5, 5, 5, 5, 5]",-100,-100,"[-10, -10, -10, -10, -10, -10, -10, -10, -10, -10]","[2, 2, 2, 2, 2, 2, 2, 2, 2, 2]",-100,-100,"[-10, -10, -10, -10, -10, -10, -10, -10, -10, -10]","[2, 2, 2, 2, 2, 2, 2, 2, 2, 2]",-100,-100,"[-10, -10, -10, -10, -10, -10, -10, -10, -10, -10]","[5, 5, 5, 5, 5, 5, 5, 5, 5, 5]",-100,-100,"[-10, -10, -10, -10, -10, -10, -10, -10, -10, -10]","[5, 5, 5, 5, 5, 5, 5, 5, 5, 5]",-100,-100
"[-1, -1, 10]","[1, 5, 4]",8,-92,"[-10, -10, -10, -10, -10, -10, -10, -10, -10, -10]","[2, 2, 2, 2, 2, 2, 2, 2, 2, 2]",-100,-200,"[-10, -10, -10, -10, -10, -10, -10, -10, -10, -10]","[2, 2, 2, 2, 2, 2, 2, 2, 2, 2]",-100,-200,"[-10, -10, -10, -10, -10, -10, -10, -10, -10, -10]","[2, 2, 2, 2, 2, 2, 2, 2, 2, 2]",-100,-200,"[-10, -10, -10, -10, -10, -10, -10, -10, -10, -10]","[5, 5, 5, 5, 5, 5, 5, 5, 5, 5]",-100,-200
"[-10, -10, -10, -10, -10, -10, -10, -10, -10, -10]","[5, 5, 5, 5, 5, 5, 5, 5, 5, 5]",-100,-192,"[-10, -10, -10, -10, -10, -10, -10, -10, -10, -10]","[2, 2, 2, 2, 2, 2, 2, 2, 2, 2]",-100,-300,"[-10, -10, -10, -10, -10, -10, -10, -10, -10, -10]","[2, 2, 2, 2, 2, 2, 2, 2, 2, 2]",-100,-300,"[-1, -1, 10]","[1, 5, 4]",8,-192,"[-10, -10, -10, -10, -10, -10, -10, -10, -10, -10]","[2, 2, 2, 2, 2, 2, 2, 2, 2, 2]",-100,-300
"[-10, -10, -10, -10, -10, -10, -10, -10, -10, -10]","[2, 2, 2, 2, 2, 2, 2, 2, 2, 2]",-100,-292,"[-1, -1, 10]","[1, 5, 4]",8,-292,"[-1, -1, 10]","[1, 5, 4]",8,-292,"[-10, -10, -10, -10, -10, -10, -10, -10, -10, -10]","[5, 5, 5, 5, 5, 5, 5, 5, 5, 5]",-100,-292,"[-10, -10, -10, -10, -10, -10, -10, -10, -10, -10]","[5, 5, 5, 5, 5, 5, 5, 5, 5, 5]",-100,-400
"[-10, -10, -10, -10, -10, -10, -10, -10, -10, -10]","[2, 2, 2, 2, 2, 2, 2, 2, 2, 2]",-100,-392,"[-10, -10, -10, -10, -10, -10, -10, -10, -10, -10]","[2, 2, 2, 2, 2, 2, 2, 2, 2, 2]",-100,-392,"[-10, -10, -10, -10, -10, -10, -10, -10, -10, -10]","[5, 5, 5, 5, 5, 5, 5, 5, 5, 5]",-100,-392,"[-10, -10, -10, -10, -10, -10, -10, -10, -10, -10]","[2, 2, 2, 2, 2, 2, 2, 2, 2, 2]",-100,-392,"[-10, -10, -10, -10, -10, -10, -10, -10, -10, -10]","[5, 5, 5, 5, 5, 5, 5, 5, 5, 5]",-100,-500
"[-10, -10, -10, -10, -10, -10, -10, -10, -10, -10]","[2, 2, 2, 2, 2, 2, 2, 2, 2, 2]",-100,-492,"[-10, -10, -10, -10, -10, -10, -10, -10, -10, -10]","[5, 5, 5, 5, 5, 5, 5, 5, 5, 5]",-100,-492,"[-1, -1, 10]","[1, 5, 4]",8,-384,"[-10, -10, -10, -10, -10, -10, -10, -10, -10, -10]","[2, 2, 2, 2, 2, 2, 2, 2, 2, 2]",-100,-492,"[-10, -10, -10, -10, -10, -10, -10, -10, -10, -10]","[2, 2, 2, 2, 2, 2, 2, 2, 2, 2]",-100,-600
"[-10, -10, -10, -10, -10, -10, -10, -10, -10, -10]","[5, 5, 5, 5, 5, 5, 5, 5, 5, 5]",-100,-592,"[-10, -10, -10, -10, -10, -10, -10, -10, -10, -10]","[2, 2, 2, 2, 2, 2, 2, 2, 2, 2]",-100,-592,"[-10, -10, -10, -10, -10, -10, -10, -10, -10, -10]","[2, 2, 2, 2, 2, 2, 2, 2, 2, 2]",-100,-484,"[-1, -1, 10]","[1, 5, 4]",8,-484,"[-1, -1, 10]","[1, 5, 4]",8,-592
"[-10, -10, -10, -10, -10, -10, -10, -10, -10, -10]","[5, 5, 5, 5, 5, 5, 5, 5, 5, 5]",-100,-692,"[-10, -10, -10, -10, -10, -10, -10, -10, -10, -10]","[2, 2, 2, 2, 2, 2, 2, 2, 2, 2]",-100,-692,"[-1, -1, 10]","[1, 5, 4]",8,-476,"[-10, -10, -10, -10, -10, -10, -10, -10, -10, -10]","[5, 5, 5, 5, 5, 5, 5, 5, 5, 5]",-100,-584,"[-10, -10, -10, -10, -10, -10, -10, -10, -10, -10]","[2, 2, 2, 2, 2, 2, 2, 2, 2, 2]",-100,-692
"[-10, -10, -10, -10, -10, -10, -10, -10, -10, -10]","[5, 5, 5, 5, 5, 5, 5, 5, 5, 5]",-100,-792,"[-10, -10, -10, -10, -10, -10, -10, -10, -10, -10]","[2, 2, 2, 2, 2, 2, 2, 2, 2, 2]",-100,-792,"[-10, -10, -10, -10, -10, -10, -10, -10, -10, -10]","[5, 5, 5, 5, 5, 5, 5, 5, 5, 5]",-100,-576,"[-1, -1, 10]","[1, 5, 4]",8,-576,"[-10, -10, -10, -10, -10, -10, -10, -10, -10, -10]","[2, 2, 2, 2, 2, 2, 2, 2, 2, 2]",-100,-792
"[-1, -1, 10]","[1, 5, 4]",8,-784,"[-1, -10, -10, -10, -10, -10, -10, -10, -10, -10]","[1, 1, 1, 1, 1, 1, 1, 1, 1, 1]",-91,-883,"[-1, -1, 10]","[1, 5, 4]",8,-568,"[-10, -10, -10, -10, -10, -10, -10, -10, -10, -10]","[2, 2, 2, 2, 2, 2, 2, 2, 2, 2]",-100,-676,"[-1, -1, 10]","[1, 5, 4]",8,-784
"[-10, -10, -10, -10, -10, -10, -10, -10, -10, -10]","[2, 2, 2, 2, 2, 2, 2, 2, 2, 2]",-100,-884,"[-1, -1, -1, -1, 10]","[0, 2, 4, 2, 4]",6,-877,"[-1, -1, 10]","[1, 5, 4]",8,-560,"[-10, -10, -10, -10, -10, -10, -10, -10, -10, -10]","[2, 2, 2, 2, 2, 2, 2, 2, 2, 2]",-100,-776,"[-1, -1, -1, -1, 10]","[0, 2, 4, 2, 4]",6,-778
"[-10, -10, -10, -10, -10, -10, -10, -10, -10, -10]","[5, 5, 5, 5, 5, 5, 5, 5, 5, 5]",-100,-984,"[-10, -10, -10, -10, -10, -10, -10, -10, -10, -10]","[5, 5, 5, 5, 5, 5, 5, 5, 5, 5]",-100,-977,"[-1, -1, -1, 10]","[0, 4, 2, 4]",7,-553,"[-10, -10, -10, -10, -10, -10, -10, -10, -10, -10]","[5, 5, 5, 5, 5, 5, 5, 5, 5, 5]",-100,-876,"[-1, -1, 10]","[1, 5, 4]",8,-770
"[-1, -1, 10]","[1, 5, 4]",8,-976,"[-1, -1, -1, 10]","[0, 4, 2, 4]",7,-970,"[-10, -10, -10, -10, -10, -10, -10, -10, -10, -10]","[2, 2, 2, 2, 2, 2, 2, 2, 2, 2]",-100,-653,"[-1, -1, 10]","[1, 5, 4]",8,-868,"[-1, -1, 10]","[1, 5, 4]",8,-762
"[-10, -10, -10, -10, -10, -10, -10, -10, -10, -10]","[2, 2, 2, 2, 2, 2, 2, 2, 2, 2]",-100,-1076,"[-1, -1, 10]","[1, 5, 4]",8,-962,"[-1, -1, 10]","[1, 5, 4]",8,-645,"[-10, -10, -10, -10, -10, -10, -10, -10, -10, -10]","[5, 5, 5, 5, 5, 5, 5, 5, 5, 5]",-100,-968,"[-10, -10, -10, -10, -10, -10, -10, -10, -10, -10]","[2, 2, 2, 2, 2, 2, 2, 2, 2, 2]",-100,-862
"[-10, -10, -10, -10, -10, -10, -10, -10, -10, -10]","[2, 2, 2, 2, 2, 2, 2, 2, 2, 2]",-100,-1176,"[-10, -10, -10, -10, -10, -10, -10, -10, -10, -10]","[2, 2, 2, 2, 2, 2, 2, 2, 2, 2]",-100,-1062,"[-10, -10, -10, -10, -10, -10, -10, -10, -10, -10]","[2, 2, 2, 2, 2, 2, 2, 2, 2, 2]",-100,-745,"[-10, -10, -10, -10, -10, -10, -10, -10, -10, -10]","[5, 5, 5, 5, 5, 5, 5, 5, 5, 5]",-100,-1068,"[-1, -1, -1, -1, 10]","[0, 2, 4, 2, 4]",6,-856
"[-1, -1, 10]","[1, 5, 4]",8,-1168,"[-10, -10, -10, -10, -10, -10, -10, -10, -10, -10]","[5, 5, 5, 5, 5, 5, 5, 5, 5, 5]",-100,-1162,"[-1, -1, -1, -1, 10]","[0, 2, 4, 2, 4]",6,-739,"[-10, -10, -10, -10, -10, -10, -10, -10, -10, -10]","[2, 2, 2, 2, 2, 2, 2, 2, 2, 2]",-100,-1168,"[-1, -1, 10]","[1, 5, 4]",8,-848
"[-10, -10, -10, -10, -10, -10, -10, -10, -10, -10]","[5, 5, 5, 5, 5, 5, 5, 5, 5, 5]",-100,-1268,"[-1, -1, 10]","[1, 5, 4]",8,-1154,"[-10, -10, -10, -10, -10, -10, -10, -10, -10, -10]","[2, 2, 2, 2, 2, 2, 2, 2, 2, 2]",-100,-839,"[-10, -10, -10, -10, -10, -10, -10, -10, -10, -10]","[2, 2, 2, 2, 2, 2, 2, 2, 2, 2]",-100,-1268,"[-10, -10, -10, -10, -10, -10, -10, -10, -10, -10]","[2, 2, 2, 2, 2, 2, 2, 2, 2, 2]",-100,-948
"[-10, -10, -10, -10, -10, -10, -10, -10, -10, -10]","[2, 2, 2, 2, 2, 2, 2, 2, 2, 2]",-100,-1368,"[-1, -1, -1, -1, -1, 10]","[0, 4, 2, 4, 2, 4]",5,-1149,"[-10, -10, -10, -10, -10, -10, -10, -10, -10, -10]","[5, 5, 5, 5, 5, 5, 5, 5, 5, 5]",-100,-939,"[-10, -10, -10, -10, -10, -10, -10, -10, -10, -10]","[2, 2, 2, 2, 2, 2, 2, 2, 2, 2]",-100,-1368,"[-1, -1, 10]","[1, 5, 4]",8,-940
"[-1, -1, 10]","[1, 5, 4]",8,-1360,"[-10, -10, -10, -10, -10, -10, -10, -10, -10, -10]","[2, 2, 2, 2, 2, 2, 2, 2, 2, 2]",-100,-1249,"[-10, -10, -10, -10, -10, -10, -10, -10, -10, -10]","[2, 2, 2, 2, 2, 2, 2, 2, 2, 2]",-100,-1039,"[-10, -10, -10, -10, -10, -10, -10, -10, -10, -10]","[5, 5, 5, 5, 5, 5, 5, 5, 5, 5]",-100,-1468,"[-1, -1, -1, -1, -1, 10]","[0, 4, 2, 4, 2, 4]",5,-935
"[-10, -10, -10, -10, -10, -10, -10, -10, -10, -10]","[5, 5, 5, 5, 5, 5, 5, 5, 5, 5]",-100,-1460,"[-1, -1, 10]","[1, 5, 4]",8,-1241,"[-1, -1, 10]","[1, 5, 4]",8,-1031,"[-10, -10, -10, -10, -10, -10, -10, -10, -10, -10]","[5, 5, 5, 5, 5, 5, 5, 5, 5, 5]",-100,-1568,"[-10, -10, -10, -10, -10, -10, -10, -10, -10, -10]","[5, 5, 5, 5, 5, 5, 5, 5, 5, 5]",-100,-1035
"[-1, -1, 10]","[1, 5, 4]",8,-1452,"[-10, -10, -10, -10, -10, -10, -10, -10, -10, -10]","[2, 2, 2, 2, 2, 2, 2, 2, 2, 2]",-100,-1341,"[-10, -10, -10, -10, -10, -10, -10, -10, -10, -10]","[2, 2, 2, 2, 2, 2, 2, 2, 2, 2]",-100,-1131,"[-10, -10, -10, -10, -10, -10, -10, -10, -10, -10]","[2, 2, 2, 2, 2, 2, 2, 2, 2, 2]",-100,-1668,"[-10, -10, -10, -10, -10, -10, -10, -10, -10, -10]","[2, 2, 2, 2, 2, 2, 2, 2, 2, 2]",-100,-1135
"[-1, -1, 10]","[1, 5, 4]",8,-1444,"[-1, -1, -10, -10, -10, -10, -10, -10, -10, -10]","[0, 1, 4, 4, 4, 4, 4, 4, 4, 4]",-82,-1423,"[-10, -10, -10, -10, -10, -10, -10, -10, -10, -10]","[2, 2, 2, 2, 2, 2, 2, 2, 2, 2]",-100,-1231,"[-1, -1, -1, 10]","[0, 4, 2, 4]",7,-1661,"[-10, -10, -10, -10, -10, -10, -10, -10, -10, -10]","[2, 2, 2, 2, 2, 2, 2, 2, 2, 2]",-100,-1235
"[-1, -1, 10]","[1, 5, 4]",8,-1436,"[-1, -1, 10]","[1, 5, 4]",8,-1415,"[-10, -10, -10, -10, -10, -10, -10, -10, -10, -10]","[2, 2, 2, 2, 2, 2, 2, 2, 2, 2]",-100,-1331,"[-1, -1, 10]","[1, 5, 4]",8,-1653,"[-1, -1, -1, -1, -1, 10]","[0, 4, 2, 4, 2, 4]",5,-1230
"[-10, -10, -10, -10, -10, -10, -10, -10, -10, -10]","[2, 2, 2, 2, 2, 2, 2, 2, 2, 2]",-100,-1536,"[-10, -10, -10, -10, -10, -10, -10, -10, -10, -10]","[2, 2, 2, 2, 2, 2, 2, 2, 2, 2]",-100,-1515,"[-10, -10, -10, -10, -10, -10, -10, -10, -10, -10]","[2, 2, 2, 2, 2, 2, 2, 2, 2, 2]",-100,-1431,"[-10, -10, -10, -10, -10, -10, -10, -10, -10, -10]","[2, 2, 2, 2, 2, 2, 2, 2, 2, 2]",-100,-1753,"[-10, -10, -10, -10, -10, -10, -10, -10, -10, -10]","[5, 5, 5, 5, 5, 5, 5, 5, 5, 5]",-100,-1330
"[-10, -10, -10, -10, -10, -10, -10, -10, -10, -10]","[2, 2, 2, 2, 2, 2, 2, 2, 2, 2]",-100,-1636,"[-10, -10, -10, -10, -10, -10, -10, -10, -10, -10]","[5, 5, 5, 5, 5, 5, 5, 5, 5, 5]",-100,-1615,"[-1, -10, -10, -10, -10, -10, -10, -10, -10, -10]","[0, 1, 1, 1, 1, 1, 1, 1, 1, 1]",-91,-1522,"[-1, -1, -1, -1, -1, 10]","[0, 4, 2, 4, 2, 4]",5,-1748,"[-10, -10, -10, -10, -10, -10, -10, -10, -10, -10]","[5, 5, 5, 5, 5, 5, 5, 5, 5, 5]",-100,-1430
"[-10, -10, -10, -10, -10, -10, -10, -10, -10, -10]","[5, 5, 5, 5, 5, 5, 5, 5, 5, 5]",-100,-1736,"[-10, -10, -10, -10, -10, -10, -10, -10, -10, -10]","[2, 2, 2, 2, 2, 2, 2, 2, 2, 2]",-100,-1715,"[-10, -10, -10, -10, -10, -10, -10, -10, -10, -10]","[5, 5, 5, 5, 5, 5, 5, 5, 5, 5]",-100,-1622,"[-10, -10, -10, -10, -10, -10, -10, -10, -10, -10]","[5, 5, 5, 5, 5, 5, 5, 5, 5, 5]",-100,-1848,"[-10, -10, -10, -10, -10, -10, -10, -10, -10, -10]","[2, 2, 2, 2, 2, 2, 2, 2, 2, 2]",-100,-1530
"[-10, -10, -10, -10, -10, -10, -10, -10, -10, -10]","[2, 2, 2, 2, 2, 2, 2, 2, 2, 2]",-100,-1836,"[-10, -10, -10, -10, -10, -10, -10, -10, -10, -10]","[2, 2, 2, 2, 2, 2, 2, 2, 2, 2]",-100,-1815,"[-1, -1, -1, 10]","[0, 4, 2, 4]",7,-1615,"[-10, -10, -10, -10, -10, -10, -10, -10, -10, -10]","[2, 2, 2, 2, 2, 2, 2, 2, 2, 2]",-100,-1948,"[-1, -1, 10]","[1, 5, 4]",8,-1522
"[-10, -10, -10, -10, -10, -10, -10, -10, -10, -10]","[5, 5, 5, 5, 5, 5, 5, 5, 5, 5]",-100,-1936,"[-10, -10, -10, -10, -10, -10, -10, -10, -10, -10]","[2, 2, 2, 2, 2, 2, 2, 2, 2, 2]",-100,-1915,"[-1, -1, -1, -1, -1, 10]","[0, 4, 2, 4, 2, 4]",5,-1610,"[-10, -10, -10, -10, -10, -10, -10, -10, -10, -10]","[5, 5, 5, 5, 5, 5, 5, 5, 5, 5]",-100,-2048,"[-10, -10, -10, -10, -10, -10, -10, -10, -10, -10]","[5, 5, 5, 5, 5, 5, 5, 5, 5, 5]",-100,-1622
"[-1, -1, 10]","[1, 5, 4]",8,-1928,"[-10, -10, -10, -10, -10, -10, -10, -10, -10, -10]","[5, 5, 5, 5, 5, 5, 5, 5, 5, 5]",-100,-2015,"[-1, -1, 10]","[1, 5, 4]",8,-1602,"[-10, -10, -10, -10, -10, -10, -10, -10, -10, -10]","[5, 5, 5, 5, 5, 5, 5, 5, 5, 5]",-100,-2148,"[-10, -10, -10, -10, -10, -10, -10, -10, -10, -10]","[2, 2, 2, 2, 2, 2, 2, 2, 2, 2]",-100,-1722
"[-10, -10, -10, -10, -10, -10, -10, -10, -10, -10]","[5, 5, 5, 5, 5, 5, 5, 5, 5, 5]",-100,-2028,"[-1, -1, 10]","[1, 5, 4]",8,-2007,"[-10, -10, -10, -10, -10, -10, -10, -10, -10, -10]","[5, 5, 5, 5, 5, 5, 5, 5, 5, 5]",-100,-1702,"[-1, -1, 10]","[1, 5, 4]",8,-2140,"[-1, -1, 10]","[1, 5, 4]",8,-1714
"[-1, -1, 10]","[1, 5, 4]",8,-2020,"[-10, -10, -10, -10, -10, -10, -10, -10, -10, -10]","[5, 5, 5, 5, 5, 5, 5, 5, 5, 5]",-100,-2107,"[-10, -10, -10, -10, -10, -10, -10, -10, -10, -10]","[5, 5, 5, 5, 5, 5, 5, 5, 5, 5]",-100,-1802,"[-10, -10, -10, -10, -10, -10, -10, -10, -10, -10]","[2, 2, 2, 2, 2, 2, 2, 2, 2, 2]",-100,-2240,"[-10, -10, -10, -10, -10, -10, -10, -10, -10, -10]","[2, 2, 2, 2, 2, 2, 2, 2, 2, 2]",-100,-1814
"[-10, -10, -10, -10, -10, -10, -10, -10, -10, -10]","[2, 2, 2, 2, 2, 2, 2, 2, 2, 2]",-100,-2120,"[-1, -1, -1, 10]","[0, 4, 2, 4]",7,-2100,"[-10, -10, -10, -10, -10, -10, -10, -10, -10, -10]","[5, 5, 5, 5, 5, 5, 5, 5, 5, 5]",-100,-1902,"[-10, -10, -10, -10, -10, -10, -10, -10, -10, -10]","[2, 2, 2, 2, 2, 2, 2, 2, 2, 2]",-100,-2340,"[-1, -1, 10]","[1, 5, 4]",8,-1806
"[-10, -10, -10, -10, -10, -10, -10, -10, -10, -10]","[2, 2, 2, 2, 2, 2, 2, 2, 2, 2]",-100,-2220,"[-10, -10, -10, -10, -10, -10, -10, -10, -10, -10]","[2, 2, 2, 2, 2, 2, 2, 2, 2, 2]",-100,-2200,"[-1, -1, 10]","[1, 5, 4]",8,-1894,"[-10, -10, -10, -10, -10, -10, -10, -10, -10, -10]","[5, 5, 5, 5, 5, 5, 5, 5, 5, 5]",-100,-2440,"[-10, -10, -10, -10, -10, -10, -10, -10, -10, -10]","[2, 2, 2, 2, 2, 2, 2, 2, 2, 2]",-100,-1906
"[-10, -10, -10, -10, -10, -10, -10, -10, -10, -10]","[5, 5, 5, 5, 5, 5, 5, 5, 5, 5]",-100,-2320,"[-1, -1, -1, 10]","[0, 4, 2, 4]",7,-2193,"[-10, -10, -10, -10, -10, -10, -10, -10, -10, -10]","[2, 2, 2, 2, 2, 2, 2, 2, 2, 2]",-100,-1994,"[-10, -10, -10, -10, -10, -10, -10, -10, -10, -10]","[2, 2, 2, 2, 2, 2, 2, 2, 2, 2]",-100,-2540,"[-10, -10, -10, -10, -10, -10, -10, -10, -10, -10]","[2, 2, 2, 2, 2, 2, 2, 2, 2, 2]",-100,-2006
"[-10, -10, -10, -10, -10, -10, -10, -10, -10, -10]","[2, 2, 2, 2, 2, 2, 2, 2, 2, 2]",-100,-2420,"[-10, -10, -10, -10, -10, -10, -10, -10, -10, -10]","[2, 2, 2, 2, 2, 2, 2, 2, 2, 2]",-100,-2293,"[-1, -1, 10]","[1, 5, 4]",8,-1986,"[-1, -1, 10]","[1, 5, 4]",8,-2532,"[-1, -1, 10]","[1, 5, 4]",8,-1998
"[-1, -1, -1, -1, -1, 10]","[0, 4, 2, 4, 2, 4]",5,-2415,"[-10, -10, -10, -10, -10, -10, -10, -10, -10, -10]","[2, 2, 2, 2, 2, 2, 2, 2, 2, 2]",-100,-2393,"[-10, -10, -10, -10, -10, -10, -10, -10, -10, -10]","[2, 2, 2, 2, 2, 2, 2, 2, 2, 2]",-100,-2086,"[-10, -10, -10, -10, -10, -10, -10, -10, -10, -10]","[2, 2, 2, 2, 2, 2, 2, 2, 2, 2]",-100,-2632,"[-10, -10, -10, -10, -10, -10, -10, -10, -10, -10]","[5, 5, 5, 5, 5, 5, 5, 5, 5, 5]",-100,-2098
"[-1, -1, 10]","[1, 5, 4]",8,-2407,"[-1, -1, -1, 10]","[0, 4, 2, 4]",7,-2386,"[-1, -1, 10]","[1, 5, 4]",8,-2078,"[-10, -10, -10, -10, -10, -10, -10, -10, -10, -10]","[5, 5, 5, 5, 5, 5, 5, 5, 5, 5]",-100,-2732,"[-1, -1, 10]","[1, 5, 4]",8,-2090
"[-10, -10, -10, -10, -10, -10, -10, -10, -10, -10]","[2, 2, 2, 2, 2, 2, 2, 2, 2, 2]",-100,-2507,"[-10, -10, -10, -10, -10, -10, -10, -10, -10, -10]","[5, 5, 5, 5, 5, 5, 5, 5, 5, 5]",-100,-2486,"[-10, -10, -10, -10, -10, -10, -10, -10, -10, -10]","[5, 5, 5, 5, 5, 5, 5, 5, 5, 5]",-100,-2178,"[-10, -10, -10, -10, -10, -10, -10, -10, -10, -10]","[2, 2, 2, 2, 2, 2, 2, 2, 2, 2]",-100,-2832,"[-10, -10, -10, -10, -10, -10, -10, -10, -10, -10]","[2, 2, 2, 2, 2, 2, 2, 2, 2, 2]",-100,-2190
"[-1, -1, -1, -1, 10]","[0, 2, 4, 2, 4]",6,-2501,"[-1, -1, 10]","[1, 5, 4]",8,-2478,"[-10, -10, -10, -10, -10, -10, -10, -10, -10, -10]","[5, 5, 5, 5, 5, 5, 5, 5, 5, 5]",-100,-2278,"[-10, -10, -10, -10, -10, -10, -10, -10, -10, -10]","[5, 5, 5, 5, 5, 5, 5, 5, 5, 5]",-100,-2932,"[-10, -10, -10, -10, -10, -10, -10, -10, -10, -10]","[2, 2, 2, 2, 2, 2, 2, 2, 2, 2]",-100,-2290
"[-10, -10, -10, -10, -10, -10, -10, -10, -10, -10]","[2, 2, 2, 2, 2, 2, 2, 2, 2, 2]",-100,-2601,"[-10, -10, -10, -10, -10, -10, -10, -10, -10, -10]","[2, 2, 2, 2, 2, 2, 2, 2, 2, 2]",-100,-2578,"[-1, -1, 10]","[1, 5, 4]",8,-2270,"[-1, -1, 10]","[1, 5, 4]",8,-2924,"[-1, -1, 10]","[1, 5, 4]",8,-2282
"[-10, -10, -10, -10, -10, -10, -10, -10, -10, -10]","[5, 5, 5, 5, 5, 5, 5, 5, 5, 5]",-100,-2701,"[-10, -10, -10, -10, -10, -10, -10, -10, -10, -10]","[5, 5, 5, 5, 5, 5, 5, 5, 5, 5]",-100,-2678,"[-10, -10, -10, -10, -10, -10, -10, -10, -10, -10]","[5, 5, 5, 5, 5, 5, 5, 5, 5, 5]",-100,-2370,"[-10, -10, -10, -10, -10, -10, -10, -10, -10, -10]","[2, 2, 2, 2, 2, 2, 2, 2, 2, 2]",-100,-3024,"[-10, -10, -10, -10, -10, -10, -10, -10, -10, -10]","[2, 2, 2, 2, 2, 2, 2, 2, 2, 2]",-100,-2382
"[-1, -1, 10]","[1, 5, 4]",8,-2693,"[-10, -10, -10, -10, -10, -10, -10, -10, -10, -10]","[5, 5, 5, 5, 5, 5, 5, 5, 5, 5]",-100,-2778,"[-10, -10, -10, -10, -10, -10, -10, -10, -10, -10]","[5, 5, 5, 5, 5, 5, 5, 5, 5, 5]",-100,-2470,"[-10, -10, -10, -10, -10, -10, -10, -10, -10, -10]","[5, 5, 5, 5, 5, 5, 5, 5, 5, 5]",-100,-3124,"[-10, -10, -10, -10, -10, -10, -10, -10, -10, -10]","[2, 2, 2, 2, 2, 2, 2, 2, 2, 2]",-100,-2482
"[-10, -10, -10, -10, -10, -10, -10, -10, -10, -10]","[2, 2, 2, 2, 2, 2, 2, 2, 2, 2]",-100,-2793,"[-10, -10, -10, -10, -10, -10, -10, -10, -10, -10]","[2, 2, 2, 2, 2, 2, 2, 2, 2, 2]",-100,-2878,"[-10, -10, -10, -10, -10, -10, -10, -10, -10, -10]","[5, 5, 5, 5, 5, 5, 5, 5, 5, 5]",-100,-2570,"[-10, -10, -10, -10, -10, -10, -10, -10, -10, -10]","[2, 2, 2, 2, 2, 2, 2, 2, 2, 2]",-100,-3224,"[-1, -1, 10]","[1, 5, 4]",8,-2474
"[-10, -10, -10, -10, -10, -10, -10, -10, -10, -10]","[5, 5, 5, 5, 5, 5, 5, 5, 5, 5]",-100,-2893,"[-10, -10, -10, -10, -10, -10, -10, -10, -10, -10]","[2, 2, 2, 2, 2, 2, 2, 2, 2, 2]",-100,-2978,"[-1, -1, -1, 10]","[0, 4, 2, 4]",7,-2563,"[-1, -1, 10]","[1, 5, 4]",8,-3216,"[-10, -10, -10, -10, -10, -10, -10, -10, -10, -10]","[2, 2, 2, 2, 2, 2, 2, 2, 2, 2]",-100,-2574
"[-1, -1, -1, -1, -1, 10]","[0, 4, 2, 4, 2, 4]",5,-2888,"[-10, -10, -10, -10, -10, -10, -10, -10, -10, -10]","[2, 2, 2, 2, 2, 2, 2, 2, 2, 2]",-100,-3078,"[-10, -10, -10, -10, -10, -10, -10, -10, -10, -10]","[5, 5, 5, 5, 5, 5, 5, 5, 5, 5]",-100,-2663,"[-1, -1, 10]","[1, 5, 4]",8,-3208,"[-10, -10, -10, -10, -10, -10, -10, -10, -10, -10]","[5, 5, 5, 5, 5, 5, 5, 5, 5, 5]",-100,-2674
"[-10, -10, -10, -10, -10, -10, -10, -10, -10, -10]","[2, 2, 2, 2, 2, 2, 2, 2, 2, 2]",-100,-2988,"[-10, -10, -10, -10, -10, -10, -10, -10, -10, -10]","[5, 5, 5, 5, 5, 5, 5, 5, 5, 5]",-100,-3178,"[-10, -10, -10, -10, -10, -10, -10, -10, -10, -10]","[2, 2, 2, 2, 2, 2, 2, 2, 2, 2]",-100,-2763,"[-10, -10, -10, -10, -10, -10, -10, -10, -10, -10]","[5, 5, 5, 5, 5, 5, 5, 5, 5, 5]",-100,-3308,"[-1, -1, 10]","[1, 5, 4]",8,-2666
"[-1, -1, 10]","[1, 5, 4]",8,-2980,"[-1, -1, 10]","[1, 5, 4]",8,-3170,"[-10, -10, -10, -10, -10, -10, -10, -10, -10, -10]","[2, 2, 2, 2, 2, 2, 2, 2, 2, 2]",-100,-2863,"[-10, -10, -10, -10, -10, -10, -10, -10, -10, -10]","[2, 2, 2, 2, 2, 2, 2, 2, 2, 2]",-100,-3408,"[-10, -10, -10, -10, -10, -10, -10, -10, -10, -10]","[2, 2, 2, 2, 2, 2, 2, 2, 2, 2]",-100,-2766
"[-1, -1, 10]","[1, 5, 4]",8,-2972,"[-10, -10, -10, -10, -10, -10, -10, -10, -10, -10]","[2, 2, 2, 2, 2, 2, 2, 2, 2, 2]",-100,-3270,"[-1, -1, 10]","[1, 5, 4]",8,-2855,"[-1, -1, -1, -1, 10]","[0, 2, 4, 2, 4]",6,-3402,"[-1, -1, 10]","[1, 5, 4]",8,-2758
"[-1, -1, 10]","[1, 5, 4]",8,-2964,"[-1, -1, -1, -1, -1, 10]","[0, 4, 2, 4, 2, 4]",5,-3265,"[-1, -1, 10]","[1, 5, 4]",8,-2847,"[-10, -10, -10, -10, -10, -10, -10, -10, -10, -10]","[2, 2, 2, 2, 2, 2, 2, 2, 2, 2]",-100,-3502,"[-10, -10, -10, -10, -10, -10, -10, -10, -10, -10]","[5, 5, 5, 5, 5, 5, 5, 5, 5, 5]",-100,-2858
"[-1, -1, 10]","[1, 5, 4]",8,-2956,"[-10, -10, -10, -10, -10, -10, -10, -10, -10, -10]","[2, 2, 2, 2, 2, 2, 2, 2, 2, 2]",-100,-3365,"[-1, -1, -1, 10]","[0, 4, 2, 4]",7,-2840,"[-10, -10, -10, -10, -10, -10, -10, -10, -10, -10]","[2, 2, 2, 2, 2, 2, 2, 2, 2, 2]",-100,-3602,"[-10, -10, -10, -10, -10, -10, -10, -10, -10, -10]","[2, 2, 2, 2, 2, 2, 2, 2, 2, 2]",-100,-2958
"[-1, -1, -1, -1, 10]","[0, 2, 4, 2, 4]",6,-2950,"[-10, -10, -10, -10, -10, -10, -10, -10, -10, -10]","[5, 5, 5, 5, 5, 5, 5, 5, 5, 5]",-100,-3465,"[-10, -10, -10, -10, -10, -10, -10, -10, -10, -10]","[2, 2, 2, 2, 2, 2, 2, 2, 2, 2]",-100,-2940,"[-10, -10, -10, -10, -10, -10, -10, -10, -10, -10]","[2, 2, 2, 2, 2, 2, 2, 2, 2, 2]",-100,-3702,"[-10, -10, -10, -10, -10, -10, -10, -10, -10, -10]","[5, 5, 5, 5, 5, 5, 5, 5, 5, 5]",-100,-3058
"[-10, -10, -10, -10, -10, -10, -10, -10, -10, -10]","[5, 5, 5, 5, 5, 5, 5, 5, 5, 5]",-100,-3050,"[-10, -10, -10, -10, -10, -10, -10, -10, -10, -10]","[2, 2, 2, 2, 2, 2, 2, 2, 2, 2]",-100,-3565,"[-10, -10, -10, -10, -10, -10, -10, -10, -10, -10]","[5, 5, 5, 5, 5, 5, 5, 5, 5, 5]",-100,-3040,"[-1, -1, -1, -1, -1, 10]","[0, 4, 2, 4, 2, 4]",5,-3697,"[-10, -10, -10, -10, -10, -10, -10, -10, -10, -10]","[2, 2, 2, 2, 2, 2, 2, 2, 2, 2]",-100,-3158
"[-10, -10, -10, -10, -10, -10, -10, -10, -10, -10]","[5, 5, 5, 5, 5, 5, 5, 5, 5, 5]",-100,-3150,"[-1, -1, 10]","[1, 5, 4]",8,-3557,"[-10, -10, -10, -10, -10, -10, -10, -10, -10, -10]","[2, 2, 2, 2, 2, 2, 2, 2, 2, 2]",-100,-3140,"[-10, -10, -10, -10, -10, -10, -10, -10, -10, -10]","[5, 5, 5, 5, 5, 5, 5, 5, 5, 5]",-100,-3797,"[-10, -10, -10, -10, -10, -10, -10, -10, -10, -10]","[5, 5, 5, 5, 5, 5, 5, 5, 5, 5]",-100,-3258
"[-10, -10, -10, -10, -10, -10, -10, -10, -10, -10]","[2, 2, 2, 2, 2, 2, 2, 2, 2, 2]",-100,-3250,"[-10, -10, -10, -10, -10, -10, -10, -10, -10, -10]","[2, 2, 2, 2, 2, 2, 2, 2, 2, 2]",-100,-3657,"[-10, -10, -10, -10, -10, -10, -10, -10, -10, -10]","[2, 2, 2, 2, 2, 2, 2, 2, 2, 2]",-100,-3240,"[-1, -1, 10]","[1, 5, 4]",8,-3789,"[-10, -10, -10, -10, -10, -10, -10, -10, -10, -10]","[2, 2, 2, 2, 2, 2, 2, 2, 2, 2]",-100,-3358
"[-1, -1, 10]","[1, 5, 4]",8,-3242,"[-1, -1, 10]","[1, 5, 4]",8,-3649,"[-10, -10, -10, -10, -10, -10, -10, -10, -10, -10]","[2, 2, 2, 2, 2, 2, 2, 2, 2, 2]",-100,-3340,"[-1, -1, -1, -1, -1, 10]","[0, 4, 2, 4, 2, 4]",5,-3784,"[-10, -10, -10, -10, -10, -10, -10, -10, -10, -10]","[2, 2, 2, 2, 2, 2, 2, 2, 2, 2]",-100,-3458
"[-1, -1, 10]","[1, 5, 4]",8,-3234,"[-10, -10, -10, -10, -10, -10, -10, -10, -10, -10]","[5, 5, 5, 5, 5, 5, 5, 5, 5, 5]",-100,-3749,"[-10, -10, -10, -10, -10, -10, -10, -10, -10, -10]","[2, 2, 2, 2, 2, 2, 2, 2, 2, 2]",-100,-3440,"[-1, -1, 10]","[1, 5, 4]",8,-3776,"[-1, -1, 10]","[1, 5, 4]",8,-3450
"[-10, -10, -10, -10, -10, -10, -10, -10, -10, -10]","[5, 5, 5, 5, 5, 5, 5, 5, 5, 5]",-100,-3334,"[-10, -10, -10, -10, -10, -10, -10, -10, -10, -10]","[2, 2, 2, 2, 2, 2, 2, 2, 2, 2]",-100,-3849,"[-10, -10, -10, -10, -10, -10, -10, -10, -10, -10]","[5, 5, 5, 5, 5, 5, 5, 5, 5, 5]",-100,-3540,"[-10, -10, -10, -10, -10, -10, -10, -10, -10, -10]","[5, 5, 5, 5, 5, 5, 5, 5, 5, 5]",-100,-3876,"[-10, -10, -10, -10, -10, -10, -10, -10, -10, -10]","[2, 2, 2, 2, 2, 2, 2, 2, 2, 2]",-100,-3550
"[-1, -1, 10]","[1, 5, 4]",8,-3326,"[-10, -10, -10, -10, -10, -10, -10, -10, -10, -10]","[5, 5, 5, 5, 5, 5, 5, 5, 5, 5]",-100,-3949,"[-10, -10, -10, -10, -10, -10, -10, -10, -10, -10]","[5, 5, 5, 5, 5, 5, 5, 5, 5, 5]",-100,-3640,"[-1, -1, 10]","[1, 5, 4]",8,-3868,"[-1, -1, 10]","[1, 5, 4]",8,-3542
"[-10, -10, -10, -10, -10, -10, -10, -10, -10, -10]","[2, 2, 2, 2, 2, 2, 2, 2, 2, 2]",-100,-3426,"[-10, -10, -10, -10, -10, -10, -10, -10, -10, -10]","[5, 5, 5, 5, 5, 5, 5, 5, 5, 5]",-100,-4049,"[-1, -1, 10]","[1, 5, 4]",8,-3632,"[-1, -1, 10]","[1, 5, 4]",8,-3860,"[-10, -10, -10, -10, -10, -10, -10, -10, -10, -10]","[2, 2, 2, 2, 2, 2, 2, 2, 2, 2]",-100,-3642
"[-1, -1, 10]","[1, 5, 4]",8,-3418,"[-10, -10, -10, -10, -10, -10, -10, -10, -10, -10]","[2, 2, 2, 2, 2, 2, 2, 2, 2, 2]",-100,-4149,"[-1, -1, 10]","[1, 5, 4]",8,-3624,"[-10, -10, -10, -10, -10, -10, -10, -10, -10, -10]","[5, 5, 5, 5, 5, 5, 5, 5, 5, 5]",-100,-3960,"[-1, -1, 10]","[1, 5, 4]",8,-3634
"[-10, -10, -10, -10, -10, -10, -10, -10, -10, -10]","[5, 5, 5, 5, 5, 5, 5, 5, 5, 5]",-100,-3518,"[-1, -1, 10]","[0, 2, 4]",8,-4141,"[-10, -10, -10, -10, -10, -10, -10, -10, -10, -10]","[2, 2, 2, 2, 2, 2, 2, 2, 2, 2]",-100,-3724,"[-10, -10, -10, -10, -10, -10, -10, -10, -10, -10]","[2, 2, 2, 2, 2, 2, 2, 2, 2, 2]",-100,-4060,"[-10, -10, -10, -10, -10, -10, -10, -10, -10, -10]","[2, 2, 2, 2, 2, 2, 2, 2, 2, 2]",-100,-3734
"[-10, -10, -10, -10, -10, -10, -10, -10, -10, -10]","[5, 5, 5, 5, 5, 5, 5, 5, 5, 5]",-100,-3618,"[-1, -1, 10]","[1, 5, 4]",8,-4133,"[-10, -10, -10, -10, -10, -10, -10, -10, -10, -10]","[5, 5, 5, 5, 5, 5, 5, 5, 5, 5]",-100,-3824,"[-10, -10, -10, -10, -10, -10, -10, -10, -10, -10]","[5, 5, 5, 5, 5, 5, 5, 5, 5, 5]",-100,-4160,"[-1, -1, 10]","[1, 5, 4]",8,-3726
"[-10, -10, -10, -10, -10, -10, -10, -10, -10, -10]","[2, 2, 2, 2, 2, 2, 2, 2, 2, 2]",-100,-3718,"[-10, -10, -10, -10, -10, -10, -10, -10, -10, -10]","[5, 5, 5, 5, 5, 5, 5, 5, 5, 5]",-100,-4233,"[-10, -10, -10, -10, -10, -10, -10, -10, -10, -10]","[5, 5, 5, 5, 5, 5, 5, 5, 5, 5]",-100,-3924,"[-10, -10, -10, -10, -10, -10, -10, -10, -10, -10]","[5, 5, 5, 5, 5, 5, 5, 5, 5, 5]",-100,-4260,"[-10, -10, -10, -10, -10, -10, -10, -10, -10, -10]","[2, 2, 2, 2, 2, 2, 2, 2, 2, 2]",-100,-3826
"[-1, -1, 10]","[1, 5, 4]",8,-3710,"[-10, -10, -10, -10, -10, -10, -10, -10, -10, -10]","[2, 2, 2, 2, 2, 2, 2, 2, 2, 2]",-100,-4333,"[-10, -10, -10, -10, -10, -10, -10, -10, -10, -10]","[5, 5, 5, 5, 5, 5, 5, 5, 5, 5]",-100,-4024,"[-1, -1, -1, -1, 10]","[0, 2, 4, 2, 4]",6,-4254,"[-1, -1, 10]","[1, 5, 4]",8,-3818
"[-1, -1, 10]","[1, 5, 4]",8,-3702,"[-10, -10, -10, -10, -10, -10, -10, -10, -10, -10]","[2, 2, 2, 2, 2, 2, 2, 2, 2, 2]",-100,-4433,"[-10, -10, -10, -10, -10, -10, -10, -10, -10, -10]","[2, 2, 2, 2, 2, 2, 2, 2, 2, 2]",-100,-4124,"[-10, -10, -10, -10, -10, -10, -10, -10, -10, -10]","[2, 2, 2, 2, 2, 2, 2, 2, 2, 2]",-100,-4354,"[-10, -10, -10, -10, -10, -10, -10, -10, -10, -10]","[5, 5, 5, 5, 5, 5, 5, 5, 5, 5]",-100,-3918
"[-10, -10, -10, -10, -10, -10, -10, -10, -10, -10]","[2, 2, 2, 2, 2, 2, 2, 2, 2, 2]",-100,-3802,"[-10, -10, -10, -10, -10, -10, -10, -10, -10, -10]","[5, 5, 5, 5, 5, 5, 5, 5, 5, 5]",-100,-4533,"[-10, -10, -10, -10, -10, -10, -10, -10, -10, -10]","[2, 2, 2, 2, 2, 2, 2, 2, 2, 2]",-100,-4224,"[-1, -1, 10]","[1, 5, 4]",8,-4346,"[-10, -10, -10, -10, -10, -10, -10, -10, -10, -10]","[2, 2, 2, 2, 2, 2, 2, 2, 2, 2]",-100,-4018
"[-10, -10, -10, -10, -10, -10, -10, -10, -10, -10]","[2, 2, 2, 2, 2, 2, 2, 2, 2, 2]",-100,-3902,"[-10, -10, -10, -10, -10, -10, -10, -10, -10, -10]","[5, 5, 5, 5, 5, 5, 5, 5, 5, 5]",-100,-4633,"[-10, -10, -10, -10, -10, -10, -10, -10, -10, -10]","[5, 5, 5, 5, 5, 5, 5, 5, 5, 5]",-100,-4324,"[-1, -1, 10]","[0, 2, 4]",8,-4338,"[-10, -10, -10, -10, -10, -10, -10, -10, -10, -10]","[5, 5, 5, 5, 5, 5, 5, 5, 5, 5]",-100,-4118
"[-1, -1, -1, -1, 10]","[0, 2, 4, 2, 4]",6,-3896,"[-1, -1, 10]","[1, 5, 4]",8,-4625,"[-10, -10, -10, -10, -10, -10, -10, -10, -10, -10]","[2, 2, 2, 2, 2, 2, 2, 2, 2, 2]",-100,-4424,"[-10, -10, -10, -10, -10, -10, -10, -10, -10, -10]","[2, 2, 2, 2, 2, 2, 2, 2, 2, 2]",-100,-4438,"[-10, -10, -10, -10, -10, -10, -10, -10, -10, -10]","[2, 2, 2, 2, 2, 2, 2, 2, 2, 2]",-100,-4218
"[-1, -1, 10]","[1, 5, 4]",8,-3888,"[-1, -1, -1, -1, -1, 10]","[0, 4, 2, 4, 2, 4]",5,-4620,"[-10, -10, -10, -10, -10, -10, -10, -10, -10, -10]","[5, 5, 5, 5, 5, 5, 5, 5, 5, 5]",-100,-4524,"[-10, -10, -10, -10, -10, -10, -10, -10, -10, -10]","[2, 2, 2, 2, 2, 2, 2, 2, 2, 2]",-100,-4538,"[-1, -1, 10]","[1, 5, 4]",8,-4210
"[-10, -10, -10, -10, -10, -10, -10, -10, -10, -10]","[5, 5, 5, 5, 5, 5, 5, 5, 5, 5]",-100,-3988,"[-10, -10, -10, -10, -10, -10, -10, -10, -10, -10]","[2, 2, 2, 2, 2, 2, 2, 2, 2, 2]",-100,-4720,"[-1, -1, 10]","[1, 5, 4]",8,-4516,"[-10, -10, -10, -10, -10, -10, -10, -10, -10, -10]","[2, 2, 2, 2, 2, 2, 2, 2, 2, 2]",-100,-4638,"[-10, -10, -10, -10, -10, -10, -10, -10, -10, -10]","[2, 2, 2, 2, 2, 2, 2, 2, 2, 2]",-100,-4310
"[-10, -10, -10, -10, -10, -10, -10, -10, -10, -10]","[2, 2, 2, 2, 2, 2, 2, 2, 2, 2]",-100,-4088,"[-10, -10, -10, -10, -10, -10, -10, -10, -10, -10]","[5, 5, 5, 5, 5, 5, 5, 5, 5, 5]",-100,-4820,"[-10, -10, -10, -10, -10, -10, -10, -10, -10, -10]","[2, 2, 2, 2, 2, 2, 2, 2, 2, 2]",-100,-4616,"[-10, -10, -10, -10, -10, -10, -10, -10, -10, -10]","[2, 2, 2, 2, 2, 2, 2, 2, 2, 2]",-100,-4738,"[-1, -1, 10]","[1, 5, 4]",8,-4302
"[-1, -1, -1, -1, 10]","[0, 2, 4, 2, 4]",6,-4082,"[-1, -1, 10]","[1, 5, 4]",8,-4812,"[-10, -10, -10, -10, -10, -10, -10, -10, -10, -10]","[2, 2, 2, 2, 2, 2, 2, 2, 2, 2]",-100,-4716,"[-10, -10, -10, -10, -10, -10, -10, -10, -10, -10]","[5, 5, 5, 5, 5, 5, 5, 5, 5, 5]",-100,-4838,"[-10, -10, -10, -10, -10, -10, -10, -10, -10, -10]","[5, 5, 5, 5, 5, 5, 5, 5, 5, 5]",-100,-4402
"[-10, -10, -10, -10, -10, -10, -10, -10, -10, -10]","[5, 5, 5, 5, 5, 5, 5, 5, 5, 5]",-100,-4182,"[-10, -10, -10, -10, -10, -10, -10, -10, -10, -10]","[2, 2, 2, 2, 2, 2, 2, 2, 2, 2]",-100,-4912,"[-10, -10, -10, -10, -10, -10, -10, -10, -10, -10]","[2, 2, 2, 2, 2, 2, 2, 2, 2, 2]",-100,-4816,"[-10, -10, -10, -10, -10, -10, -10, -10, -10, -10]","[2, 2, 2, 2, 2, 2, 2, 2, 2, 2]",-100,-4938,"[-1, -1, 10]","[1, 5, 4]",8,-4394
"[-1, -1, 10]","[1, 5, 4]",8,-4174,"[-1, -1, 10]","[1, 5, 4]",8,-4904,"[-1, -1, 10]","[1, 5, 4]",8,-4808,"[-10, -10, -10, -10, -10, -10, -10, -10, -10, -10]","[2, 2, 2, 2, 2, 2, 2, 2, 2, 2]",-100,-5038,"[-1, -1, -1, -1, 10]","[0, 2, 4, 2, 4]",6,-4388
"[-1, -1, 10]","[1, 5, 4]",8,-4166,"[-10, -10, -10, -10, -10, -10, -10, -10, -10, -10]","[5, 5, 5, 5, 5, 5, 5, 5, 5, 5]",-100,-5004,"[-1, -1, 10]","[1, 5, 4]",8,-4800,"[-10, -10, -10, -10, -10, -10, -10, -10, -10, -10]","[2, 2, 2, 2, 2, 2, 2, 2, 2, 2]",-100,-5138,"[-1, -1, 10]","[1, 5, 4]",8,-4380
"[-10, -10, -10, -10, -10, -10, -10, -10, -10, -10]","[5, 5, 5, 5, 5, 5, 5, 5, 5, 5]",-100,-4266,"[-1, -1, 10]","[0, 2, 4]",8,-4996,"[-1, -1, 10]","[0, 2, 4]",8,-4792,"[-10, -10, -10, -10, -10, -10, -10, -10, -10, -10]","[5, 5, 5, 5, 5, 5, 5, 5, 5, 5]",-100,-5238,"[-1, -1, 10]","[1, 5, 4]",8,-4372
"[-1, -1, 10]","[0, 2, 4]",8,-4258,"[-10, -10, -10, -10, -10, -10, -10, -10, -10, -10]","[5, 5, 5, 5, 5, 5, 5, 5, 5, 5]",-100,-5096,"[-10, -10, -10, -10, -10, -10, -10, -10, -10, -10]","[5, 5, 5, 5, 5, 5, 5, 5, 5, 5]",-100,-4892,"[-10, -10, -10, -10, -10, -10, -10, -10, -10, -10]","[2, 2, 2, 2, 2, 2, 2, 2, 2, 2]",-100,-5338,"[-1, -1, -1, -1, 10]","[0, 2, 4, 2, 4]",6,-4366
"[-10, -10, -10, -10, -10, -10, -10, -10, -10, -10]","[2, 2, 2, 2, 2, 2, 2, 2, 2, 2]",-100,-4358,"[-10, -10, -10, -10, -10, -10, -10, -10, -10, -10]","[2, 2, 2, 2, 2, 2, 2, 2, 2, 2]",-100,-5196,"[-10, -10, -10, -10, -10, -10, -10, -10, -10, -10]","[2, 2, 2, 2, 2, 2, 2, 2, 2, 2]",-100,-4992,"[-10, -10, -10, -10, -10, -10, -10, -10, -10, -10]","[2, 2, 2, 2, 2, 2, 2, 2, 2, 2]",-100,-5438,"[-10, -10, -10, -10, -10, -10, -10, -10, -10, -10]","[5, 5, 5, 5, 5, 5, 5, 5, 5, 5]",-100,-4466
"[-1, -1, 10]","[1, 5, 4]",8,-4350,"[-1, -1, 10]","[1, 5, 4]",8,-5188,"[-10, -10, -10, -10, -10, -10, -10, -10, -10, -10]","[2, 2, 2, 2, 2, 2, 2, 2, 2, 2]",-100,-5092,"[-10, -10, -10, -10, -10, -10, -10, -10, -10, -10]","[5, 5, 5, 5, 5, 5, 5, 5, 5, 5]",-100,-5538,"[-10, -10, -10, -10, -10, -10, -10, -10, -10, -10]","[5, 5, 5, 5, 5, 5, 5, 5, 5, 5]",-100,-4566
"[-10, -10, -10, -10, -10, -10, -10, -10, -10, -10]","[2, 2, 2, 2, 2, 2, 2, 2, 2, 2]",-100,-4450,"[-10, -10, -10, -10, -10, -10, -10, -10, -10, -10]","[5, 5, 5, 5, 5, 5, 5, 5, 5, 5]",-100,-5288,"[-10, -10, -10, -10, -10, -10, -10, -10, -10, -10]","[2, 2, 2, 2, 2, 2, 2, 2, 2, 2]",-100,-5192,"[-1, -1, 10]","[1, 5, 4]",8,-5530,"[-1, -1, 10]","[1, 5, 4]",8,-4558
"[-10, -10, -10, -10, -10, -10, -10, -10, -10, -10]","[2, 2, 2, 2, 2, 2, 2, 2, 2, 2]",-100,-4550,"[-10, -10, -10, -10, -10, -10, -10, -10, -10, -10]","[2, 2, 2, 2, 2, 2, 2, 2, 2, 2]",-100,-5388,"[-10, -10, -10, -10, -10, -10, -10, -10, -10, -10]","[5, 5, 5, 5, 5, 5, 5, 5, 5, 5]",-100,-5292,"[-1, -1, 10]","[1, 5, 4]",8,-5522,"[-1, -1, 10]","[1, 5, 4]",8,-4550
"[-1, -1, 10]","[1, 5, 4]",8,-4542,"[-10, -10, -10, -10, -10, -10, -10, -10, -10, -10]","[2, 2, 2, 2, 2, 2, 2, 2, 2, 2]",-100,-5488,"[-1, -1, 10]","[1, 5, 4]",8,-5284,"[-10, -10, -10, -10, -10, -10, -10, -10, -10, -10]","[5, 5, 5, 5, 5, 5, 5, 5, 5, 5]",-100,-5622,"[-10, -10, -10, -10, -10, -10, -10, -10, -10, -10]","[5, 5, 5, 5, 5, 5, 5, 5, 5, 5]",-100,-4650
"[-10, -10, -10, -10, -10, -10, -10, -10, -10, -10]","[2, 2, 2, 2, 2, 2, 2, 2, 2, 2]",-100,-4642,"[-10, -10, -10, -10, -10, -10, -10, -10, -10, -10]","[2, 2, 2, 2, 2, 2, 2, 2, 2, 2]",-100,-5588,"[-1, -1, 10]","[1, 5, 4]",8,-5276,"[-10, -10, -10, -10, -10, -10, -10, -10, -10, -10]","[5, 5, 5, 5, 5, 5, 5, 5, 5, 5]",-100,-5722,"[-10, -10, -10, -10, -10, -10, -10, -10, -10, -10]","[2, 2, 2, 2, 2, 2, 2, 2, 2, 2]",-100,-4750
"[-10, -10, -10, -10, -10, -10, -10, -10, -10, -10]","[2, 2, 2, 2, 2, 2, 2, 2, 2, 2]",-100,-4742,"[-10, -10, -10, -10, -10, -10, -10, -10, -10, -10]","[2, 2, 2, 2, 2, 2, 2, 2, 2, 2]",-100,-5688,"[-10, -10, -10, -10, -10, -10, -10, -10, -10, -10]","[5, 5, 5, 5, 5, 5, 5, 5, 5, 5]",-100,-5376,"[-10, -10, -10, -10, -10, -10, -10, -10, -10, -10]","[2, 2, 2, 2, 2, 2, 2, 2, 2, 2]",-100,-5822,"[-1, -1, 10]","[0, 2, 4]",8,-4742
"[-1, -1, -1, -1, -1, 10]","[0, 4, 2, 4, 2, 4]",5,-4737,"[-10, -10, -10, -10, -10, -10, -10, -10, -10, -10]","[5, 5, 5, 5, 5, 5, 5, 5, 5, 5]",-100,-5788,"[-1, -1, 10]","[0, 2, 4]",8,-5368,"[-1, -1, 10]","[1, 5, 4]",8,-5814,"[-10, -10, -10, -10, -10, -10, -10, -10, -10, -10]","[2, 2, 2, 2, 2, 2, 2, 2, 2, 2]",-100,-4842
"[-10, -10, -10, -10, -10, -10, -10, -10, -10, -10]","[5, 5, 5, 5, 5, 5, 5, 5, 5, 5]",-100,-4837,"[-10, -10, -10, -10, -10, -10, -10, -10, -10, -10]","[5, 5, 5, 5, 5, 5, 5, 5, 5, 5]",-100,-5888,"[-1, -1, 10]","[1, 5, 4]",8,-5360,"[-10, -10, -10, -10, -10, -10, -10, -10, -10, -10]","[2, 2, 2, 2, 2, 2, 2, 2, 2, 2]",-100,-5914,"[-1, -1, 10]","[1, 5, 4]",8,-4834
"[-10, -10, -10, -10, -10, -10, -10, -10, -10, -10]","[2, 2, 2, 2, 2, 2, 2, 2, 2, 2]",-100,-4937,"[-10, -10, -10, -10, -10, -10, -10, -10, -10, -10]","[5, 5, 5, 5, 5, 5, 5, 5, 5, 5]",-100,-5988,"[-1, -1, 10]","[1, 5, 4]",8,-5352,"[-10, -10, -10, -10, -10, -10, -10, -10, -10, -10]","[5, 5, 5, 5, 5, 5, 5, 5, 5, 5]",-100,-6014,"[-10, -10, -10, -10, -10, -10, -10, -10, -10, -10]","[5, 5, 5, 5, 5, 5, 5, 5, 5, 5]",-100,-4934
"[-10, -10, -10, -10, -10, -10, -10, -10, -10, -10]","[2, 2, 2, 2, 2, 2, 2, 2, 2, 2]",-100,-5037,"[-10, -10, -10, -10, -10, -10, -10, -10, -10, -10]","[2, 2, 2, 2, 2, 2, 2, 2, 2, 2]",-100,-6088,"[-1, -1, 10]","[1, 5, 4]",8,-5344,"[-1, -1, 10]","[1, 5, 4]",8,-6006,"[-10, -10, -10, -10, -10, -10, -10, -10, -10, -10]","[2, 2, 2, 2, 2, 2, 2, 2, 2, 2]",-100,-5034
"[-10, -10, -10, -10, -10, -10, -10, -10, -10, -10]","[5, 5, 5, 5, 5, 5, 5, 5, 5, 5]",-100,-5137,"[-10, -10, -10, -10, -10, -10, -10, -10, -10, -10]","[2, 2, 2, 2, 2, 2, 2, 2, 2, 2]",-100,-6188,"[-1, -1, -1, 10]","[0, 4, 2, 4]",7,-5337,"[-10, -10, -10, -10, -10, -10, -10, -10, -10, -10]","[5, 5, 5, 5, 5, 5, 5, 5, 5, 5]",-100,-6106,"[-1, -1, 10]","[1, 5, 4]",8,-5026
"[-10, -10, -10, -10, -10, -10, -10, -10, -10, -10]","[2, 2, 2, 2, 2, 2, 2, 2, 2, 2]",-100,-5237,"[-10, -10, -10, -10, -10, -10, -10, -10, -10, -10]","[2, 2, 2, 2, 2, 2, 2, 2, 2, 2]",-100,-6288,"[-10, -10, -10, -10, -10, -10, -10, -10, -10, -10]","[5, 5, 5, 5, 5, 5, 5, 5, 5, 5]",-100,-5437,"[-1, -1, 10]","[1, 5, 4]",8,-6098,"[-10, -10, -10, -10, -10, -10, -10, -10, -10, -10]","[2, 2, 2, 2, 2, 2, 2, 2, 2, 2]",-100,-5126
"[-1, -1, 10]","[1, 5, 4]",8,-5229,"[-1, -1, 10]","[1, 5, 4]",8,-6280,"[-10, -10, -10, -10, -10, -10, -10, -10, -10, -10]","[2, 2, 2, 2, 2, 2, 2, 2, 2, 2]",-100,-5537,"[-10, -10, -10, -10, -10, -10, -10, -10, -10, -10]","[2, 2, 2, 2, 2, 2, 2, 2, 2, 2]",-100,-6198,"[-1, -1, 10]","[1, 5, 4]",8,-5118
"[-10, -10, -10, -10, -10, -10, -10, -10, -10, -10]","[5, 5, 5, 5, 5, 5, 5, 5, 5, 5]",-100,-5329,"[-10, -10, -10, -10, -10, -10, -10, -10, -10, -10]","[2, 2, 2, 2, 2, 2, 2, 2, 2, 2]",-100,-6380,"[-10, -10, -10, -10, -10, -10, -10, -10, -10, -10]","[5, 5, 5, 5, 5, 5, 5, 5, 5, 5]",-100,-5637,"[-10, -10, -10, -10, -10, -10, -10, -10, -10, -10]","[2, 2, 2, 2, 2, 2, 2, 2, 2, 2]",-100,-6298,"[-1, -1, 10]","[1, 5, 4]",8,-5110
"[-10, -10, -10, -10, -10, -10, -10, -10, -10, -10]","[5, 5, 5, 5, 5, 5, 5, 5, 5, 5]",-100,-5429,"[-10, -10, -10, -10, -10, -10, -10, -10, -10, -10]","[5, 5, 5, 5, 5, 5, 5, 5, 5, 5]",-100,-6480,"[-10, -10, -10, -10, -10, -10, -10, -10, -10, -10]","[2, 2, 2, 2, 2, 2, 2, 2, 2, 2]",-100,-5737,"[-1, -1, 10]","[1, 5, 4]",8,-6290,"[-1, -1, 10]","[1, 5, 4]",8,-5102
"[-10, -10, -10, -10, -10, -10, -10, -10, -10, -10]","[5, 5, 5, 5, 5, 5, 5, 5, 5, 5]",-100,-5529,"[-10, -10, -10, -10, -10, -10, -10, -10, -10, -10]","[5, 5, 5, 5, 5, 5, 5, 5, 5, 5]",-100,-6580,"[-1, -1, 10]","[1, 5, 4]",8,-5729,"[-1, -1, 10]","[1, 5, 4]",8,-6282,"[-1, -1, -1, -1, -1, 10]","[0, 4, 2, 4, 2, 4]",5,-5097
"[-1, -1, 10]","[1, 5, 4]",8,-5521,"[-1, -1, -1, -1, -1, 10]","[0, 4, 2, 4, 2, 4]",5,-6575,"[-1, -1, 10]","[1, 5, 4]",8,-5721,"[-1, -1, 10]","[1, 5, 4]",8,-6274,"[-1, -1, -1, -1, 10]","[0, 2, 4, 2, 4]",6,-5091
"[-1, -1, -1, -1, -1, 10]","[0, 4, 2, 4, 2, 4]",5,-5516,"[-10, -10, -10, -10, -10, -10, -10, -10, -10, -10]","[2, 2, 2, 2, 2, 2, 2, 2, 2, 2]",-100,-6675,"[-1, -1, -1, -1, -1, 10]","[0, 4, 2, 4, 2, 4]",5,-5716,"[-10, -10, -10, -10, -10, -10, -10, -10, -10, -10]","[2, 2, 2, 2, 2, 2, 2, 2, 2, 2]",-100,-6374,"[-10, -10, -10, -10, -10, -10, -10, -10, -10, -10]","[2, 2, 2, 2, 2, 2, 2, 2, 2, 2]",-100,-5191
"[-10, -10, -10, -10, -10, -10, -10, -10, -10, -10]","[5, 5, 5, 5, 5, 5, 5, 5, 5, 5]",-100,-5616,"[-10, -10, -10, -10, -10, -10, -10, -10, -10, -10]","[2, 2, 2, 2, 2, 2, 2, 2, 2, 2]",-100,-6775,"[-1, -1, 10]","[0, 2, 4]",8,-5708,"[-1, -1, 10]","[0, 2, 4]",8,-6366,"[-10, -10, -10, -10, -10, -10, -10, -10, -10, -10]","[2, 2, 2, 2, 2, 2, 2, 2, 2, 2]",-100,-5291
"[-1, -1, 10]","[1, 5, 4]",8,-5608,"[-10, -10, -10, -10, -10, -10, -10, -10, -10, -10]","[2, 2, 2, 2, 2, 2, 2, 2, 2, 2]",-100,-6875,"[-10, -10, -10, -10, -10, -10, -10, -10, -10, -10]","[2, 2, 2, 2, 2, 2, 2, 2, 2, 2]",-100,-5808,"[-1, -1, 10]","[0, 2, 4]",8,-6358,"[-10, -10, -10, -10, -10, -10, -10, -10, -10, -10]","[2, 2, 2, 2, 2, 2, 2, 2, 2, 2]",-100,-5391
"[-10, -10, -10, -10, -10, -10, -10, -10, -10, -10]","[5, 5, 5, 5, 5, 5, 5, 5, 5, 5]",-100,-5708,"[-10, -10, -10, -10, -10, -10, -10, -10, -10, -10]","[2, 2, 2, 2, 2, 2, 2, 2, 2, 2]",-100,-6975,"[-10, -10, -10, -10, -10, -10, -10, -10, -10, -10]","[2, 2, 2, 2, 2, 2, 2, 2, 2, 2]",-100,-5908,"[-10, -10, -10, -10, -10, -10, -10, -10, -10, -10]","[2, 2, 2, 2, 2, 2, 2, 2, 2, 2]",-100,-6458,"[-10, -10, -10, -10, -10, -10, -10, -10, -10, -10]","[5, 5, 5, 5, 5, 5, 5, 5, 5, 5]",-100,-5491
"[-10, -10, -10, -10, -10, -10, -10, -10, -10, -10]","[5, 5, 5, 5, 5, 5, 5, 5, 5, 5]",-100,-5808,"[-10, -10, -10, -10, -10, -10, -10, -10, -10, -10]","[2, 2, 2, 2, 2, 2, 2, 2, 2, 2]",-100,-7075,"[-10, -10, -10, -10, -10, -10, -10, -10, -10, -10]","[2, 2, 2, 2, 2, 2, 2, 2, 2, 2]",-100,-6008,"[-10, -10, -10, -10, -10, -10, -10, -10, -10, -10]","[2, 2, 2, 2, 2, 2, 2, 2, 2, 2]",-100,-6558,"[-10, -10, -10, -10, -10, -10, -10, -10, -10, -10]","[2, 2, 2, 2, 2, 2, 2, 2, 2, 2]",-100,-5591
